 COL ltable.Product_id VAL 489 COL ltable.Description VAL MAKE UP FOR EVER full cover concealer COL ltable.Color VAL Sand 7 	  COL rtable.ID VAL AM0877 COL rtable.Color VAL Vanilla 5 COL rtable.Description VAL MAKE UP FOR EVER Full Cover Concealer Vanilla 5 0.5 oz 	 0
 COL ltable.Product_id VAL 815 COL ltable.Description VAL Bobbi Brown sheer finish pressed powder COL ltable.Color VAL Pale Yellow 	  COL rtable.ID VAL AM1888 COL rtable.Color VAL Pale Yellow COL rtable.Description VAL Bobbi Brown Bobbi Brown Sheer Finish Pressed Powder - Pale Yellow, .38 oz 	 1
 COL ltable.Product_id VAL 4974 COL ltable.Description VAL Laura Mercier secret camouflage COL ltable.Color VAL SC-3 	  COL rtable.ID VAL AM5434 COL rtable.Color VAL SC-4 COL rtable.Description VAL Laura Mercier Secret Camouflage - Sc-4 	 0
 COL ltable.Product_id VAL 8817 COL ltable.Description VAL tarte lipsurgence lip tint COL ltable.Color VAL Elite 	  COL rtable.ID VAL AM2776 COL rtable.Color VAL Energy COL rtable.Description VAL Tarte Lipsurgence Skintuitive Lip Tint - Energy (.10 oz) 	 0
 COL ltable.Product_id VAL 1918 COL ltable.Description VAL NARS pressed powder COL ltable.Color VAL Beach 	  COL rtable.ID VAL AM0005 COL rtable.Color VAL nan COL rtable.Description VAL NARS Light Reflecting Pressed Powder 	 0
 COL ltable.Product_id VAL 972 COL ltable.Description VAL CLINIQUE chubby stick moisturizing lip colour balm COL ltable.Color VAL Two Ton Tomato 	  COL rtable.ID VAL AM2141 COL rtable.Color VAL  Woppin" Watermelon COL rtable.Description VAL Clinique - Chubby Stick Moisturizing Lip Colour Balm - # 6 Woppin' Watermelon (0.1 oz.) 1 pcs sku# 1900553MA 	 0
 COL ltable.Product_id VAL 743 COL ltable.Description VAL NARS brow gel COL ltable.Color VAL nan 	  COL rtable.ID VAL AM1630 COL rtable.Color VAL Kinshasa COL rtable.Description VAL Nars Brow Gel Kinshasa 7Ml/0.21Oz 	 0
 COL ltable.Product_id VAL 2248 COL ltable.Description VAL CLINIQUE brow shaper COL ltable.Color VAL Wheat  	  COL rtable.ID VAL AM5020 COL rtable.Color VAL Charcoaled COL rtable.Description VAL Clinique Brow Shaper Charcoaled 	 0
 COL ltable.Product_id VAL 665 COL ltable.Description VAL Giorgio Armani luminous silk foundation COL ltable.Color VAL 4 	  COL rtable.ID VAL AM1359 COL rtable.Color VAL 4.75 COL rtable.Description VAL Giorgio Armani Luminous Silk Foundation 1oz - # 4.75, (BNIB) 	 0
 COL ltable.Product_id VAL 3729 COL ltable.Description VAL Dior diorshow mascara COL ltable.Color VAL Purple 168 	  COL rtable.ID VAL AM1149 COL rtable.Color VAL 099 Kohl Black COL rtable.Description VAL Dior Diorshow Black Out Mascara Size 0.33 Oz Color Kohl Black 099 - Rich Black 	 0
 COL ltable.Product_id VAL 7348 COL ltable.Description VAL NARS larger than life lip gloss COL ltable.Color VAL Rouge Tribal 	  COL rtable.ID VAL AM1698 COL rtable.Color VAL Flamingo Pink COL rtable.Description VAL Nars Larger Than Life Lip Gloss Color Paris Follies - Flamingo Pink 	 0
 COL ltable.Product_id VAL 262 COL ltable.Description VAL Peter Thomas Roth lashes to die for the mascara COL ltable.Color VAL Black 	  COL rtable.ID VAL AM0498 COL rtable.Color VAL Black COL rtable.Description VAL Peter Thomas Roth - Lashes To Die For The Mascara - Jet Black -8ml/0.27oz 	 1
 COL ltable.Product_id VAL 8820 COL ltable.Description VAL tarte lipsurgence lip tint COL ltable.Color VAL Grateful 	  COL rtable.ID VAL AM2776 COL rtable.Color VAL Energy COL rtable.Description VAL Tarte Lipsurgence Skintuitive Lip Tint - Energy (.10 oz) 	 0
 COL ltable.Product_id VAL 9866 COL ltable.Description VAL Bobbi Brown foundation stick COL ltable.Color VAL Warm Walnut 	  COL rtable.ID VAL AM5089 COL rtable.Color VAL Warm Ivory COL rtable.Description VAL Exclusive Make Up Product By Bobbi Brown Foundation Stick - #1 Warm Ivory 9g/0.31oz 	 0
 COL ltable.Product_id VAL 1123 COL ltable.Description VAL Givenchy noir couture COL ltable.Color VAL 5 Violet Etonnant 	  COL rtable.ID VAL AM2363 COL rtable.Color VAL 2 Brown Satin COL rtable.Description VAL Givenchy Noir Couture Mascara - # 2 Brown Satin 8g/0.28oz 	 0
 COL ltable.Product_id VAL 1493 COL ltable.Description VAL CLINIQUE even better makeup spf 15 COL ltable.Color VAL Cream Caramel 	  COL rtable.ID VAL AM3661 COL rtable.Color VAL Vanilla COL rtable.Description VAL Clinique Even Better Compact Makeup SPF 15 - # 14 Vanilla (MF-G) 10g/0.35oz 	 0
 COL ltable.Product_id VAL 1102 COL ltable.Description VAL NARS makeup removing water COL ltable.Color VAL nan 	  COL rtable.ID VAL AM2306 COL rtable.Color VAL nan COL rtable.Description VAL NARS Makeup Removing Water 6.7 oz by NARS 	 1
 COL ltable.Product_id VAL 2489 COL ltable.Description VAL Bobbi Brown corrector COL ltable.Color VAL Bisque 	  COL rtable.ID VAL AM5759 COL rtable.Color VAL Bisque COL rtable.Description VAL BOBBI BROWN Corrector - Bisque 	 1
 COL ltable.Product_id VAL 4972 COL ltable.Description VAL Laura Mercier secret camouflage COL ltable.Color VAL SC-1 	  COL rtable.ID VAL AM5420 COL rtable.Color VAL SC-5 COL rtable.Description VAL Laura Mercier Secret Camouflage SC-5 	 0
 COL ltable.Product_id VAL 9865 COL ltable.Description VAL Bobbi Brown foundation stick COL ltable.Color VAL Warm Sand 	  COL rtable.ID VAL AM1422 COL rtable.Color VAL Warm Sand COL rtable.Description VAL Bobbi Brown Foundation Stick Warm Sand # 2.5 Full Size (Box) 	 1
 COL ltable.Product_id VAL 9388 COL ltable.Description VAL Bobbi Brown bronzing powder COL ltable.Color VAL Golden Light 	  COL rtable.ID VAL AM4360 COL rtable.Color VAL Tawny Brown COL rtable.Description VAL Bobbi Brown Bronzing Powder - Tawny Brown 0.28 Oz, (BNIB) 	 0
 COL ltable.Product_id VAL 500 COL ltable.Description VAL NARS push eyeliner 46 COL ltable.Color VAL nan 	  COL rtable.ID VAL AM0892 COL rtable.Color VAL nan COL rtable.Description VAL NARS Push Eyeliner #46 	 1
 COL ltable.Product_id VAL 880 COL ltable.Description VAL Shiseido foundation brush COL ltable.Color VAL nan 	  COL rtable.ID VAL AM2013 COL rtable.Color VAL nan COL rtable.Description VAL Shiseido Foundation Brush (Quantity of 1) 	 1
 COL ltable.Product_id VAL 478 COL ltable.Description VAL NARS contour blush COL ltable.Color VAL Paloma 	  COL rtable.ID VAL AM0863 COL rtable.Color VAL Olympia COL rtable.Description VAL NARS Contour Blush Powder Duo Olympia 	 0
 COL ltable.Product_id VAL 9407 COL ltable.Description VAL Laura Mercier eye colour COL ltable.Color VAL Vanilla Nuts 	  COL rtable.ID VAL AM4110 COL rtable.Color VAL nan COL rtable.Description VAL Laura Mercier Artists Palette For Eyes & Cheeks (8x Eye Colour, 1x Highlighter) - 	 0
 COL ltable.Product_id VAL 9043 COL ltable.Description VAL stila illuminating powder foundation COL ltable.Color VAL 30 Watts 	  COL rtable.ID VAL AM1645 COL rtable.Color VAL nan COL rtable.Description VAL stila Illuminating Powder Foundation Refillable Compact 	 0
 COL ltable.Product_id VAL 490 COL ltable.Description VAL MAKE UP FOR EVER full cover concealer COL ltable.Color VAL Vanilla 5 	  COL rtable.ID VAL AM0868 COL rtable.Color VAL Chocolate 18 COL rtable.Description VAL MAKE UP FOR EVER Full Cover Concealer Chocolate 18 0.5 oz 	 0
 COL ltable.Product_id VAL 1571 COL ltable.Description VAL MAKE UP FOR EVER pro finish multi use powder foundation COL ltable.Color VAL 120 Neutral Ivory 	  COL rtable.ID VAL AM3723 COL rtable.Color VAL Neutral Sand COL rtable.Description VAL Make Up For Ever Pro Finish Multi Use Powder Foundation - # 128 Neutral Sand 10g/0.35oz 	 0
 COL ltable.Product_id VAL 2550 COL ltable.Description VAL MAKE UP FOR EVER aqua eyes COL ltable.Color VAL Pistachio 17L 	  COL rtable.ID VAL AM6018 COL rtable.Color VAL Pistachio 17L COL rtable.Description VAL MAKE UP FOR EVER Aqua Eyes Pistachio 17L 0.04 oz 	 1
 COL ltable.Product_id VAL 2494 COL ltable.Description VAL Bobbi Brown corrector COL ltable.Color VAL Light Peach 	  COL rtable.ID VAL AM5759 COL rtable.Color VAL Bisque COL rtable.Description VAL BOBBI BROWN Corrector - Bisque 	 0
 COL ltable.Product_id VAL 1203 COL ltable.Description VAL Givenchy prisme quatuor COL ltable.Color VAL 9 Delicate 	  COL rtable.ID VAL AM2571 COL rtable.Color VAL 5 Frisson COL rtable.Description VAL Givenchy Prisme Quatuor 4 Colors Eyeshadow - # 5 Frisson 4x1g/0.14oz 	 0
 COL ltable.Product_id VAL 4783 COL ltable.Description VAL Estee Lauder pure color envy sculpting lipstick COL ltable.Color VAL Vengeful Red 	  COL rtable.ID VAL AM0697 COL rtable.Color VAL Blossom Bright COL rtable.Description VAL Estee Lauder Pure Color Envy Shine Sculpting Lipstick - Blossom Bright No. 250 	 0
 COL ltable.Product_id VAL 291 COL ltable.Description VAL MAKE UP FOR EVER aquarelle COL ltable.Color VAL 7 	  COL rtable.ID VAL AM0517 COL rtable.Color VAL 1 COL rtable.Description VAL MAKE UP FOR EVER Aquarelle 1 0.33 oz 	 0
 COL ltable.Product_id VAL 363 COL ltable.Description VAL MAKE UP FOR EVER artist plexi gloss COL ltable.Color VAL 400 	  COL rtable.ID VAL AM0572 COL rtable.Color VAL 403 COL rtable.Description VAL Make up for Ever Artist Plexi Gloss Lip Lacquer 403 - Red (Opaque) 	 0
 COL ltable.Product_id VAL 9845 COL ltable.Description VAL Bobbi Brown foundation stick COL ltable.Color VAL Beige 	  COL rtable.ID VAL AM1422 COL rtable.Color VAL Warm Sand COL rtable.Description VAL Bobbi Brown Foundation Stick Warm Sand # 2.5 Full Size (Box) 	 0
 COL ltable.Product_id VAL 1121 COL ltable.Description VAL Givenchy noir couture COL ltable.Color VAL 1 Black Satin 	  COL rtable.ID VAL AM2362 COL rtable.Color VAL 1 Black Satin COL rtable.Description VAL Givenchy Noir Couture Mascara - # 1 Black Satin - 8g/0.28oz 	 1
 COL ltable.Product_id VAL 420 COL ltable.Description VAL Laura Mercier camouflage powder brush COL ltable.Color VAL nan 	  COL rtable.ID VAL AM4599 COL rtable.Color VAL nan COL rtable.Description VAL Laura Mercier Camouflage Powder Brush - Long Handled - - 	 1
 COL ltable.Product_id VAL 2335 COL ltable.Description VAL Bobbi Brown bb cream broad spectrum spf 35 COL ltable.Color VAL Fair 	  COL rtable.ID VAL AM5192 COL rtable.Color VAL Light COL rtable.Description VAL Bobbi Brown BB Cream Broad Spectrum SPF 35 - # Light - 40ml/1.35oz 	 0
 COL ltable.Product_id VAL 9859 COL ltable.Description VAL Bobbi Brown foundation stick COL ltable.Color VAL Walnut 	  COL rtable.ID VAL AM5089 COL rtable.Color VAL Warm Ivory COL rtable.Description VAL Exclusive Make Up Product By Bobbi Brown Foundation Stick - #1 Warm Ivory 9g/0.31oz 	 0
 COL ltable.Product_id VAL 6561 COL ltable.Description VAL Shiseido smoothing lip pencil COL ltable.Color VAL BR607 Coffee Bean 	  COL rtable.ID VAL AM2214 COL rtable.Color VAL RD702 Anemone COL rtable.Description VAL Smoothing Lip Pencil - RD702 Anemone by Shiseido - 10076381402 	 0
 COL ltable.Product_id VAL 667 COL ltable.Description VAL Giorgio Armani luminous silk foundation COL ltable.Color VAL 4.5 	  COL rtable.ID VAL AM1389 COL rtable.Color VAL 4.5 COL rtable.Description VAL Giorgio Armani Luminous Silk Foundation - # 4.5 Sand - 30ml/1oz 	 1
 COL ltable.Product_id VAL 46 COL ltable.Description VAL Shiseido veiled rouge COL ltable.Color VAL RS308 Sloe 	  COL rtable.ID VAL AM0062 COL rtable.Color VAL PK304 Skyglow COL rtable.Description VAL Shiseido Veiled Rouge Lipstick - PK304 Skyglow 	 0
 COL ltable.Product_id VAL 7348 COL ltable.Description VAL NARS larger than life lip gloss COL ltable.Color VAL Rouge Tribal 	  COL rtable.ID VAL AM1699 COL rtable.Color VAL Strawberry Pink COL rtable.Description VAL Nars Larger Than Life Lip Gloss Color Place Vendome - Strawberry Pink 	 0
 COL ltable.Product_id VAL 981 COL ltable.Description VAL Giorgio Armani smooth silk eye pencil COL ltable.Color VAL 5 	  COL rtable.ID VAL AM2143 COL rtable.Color VAL 12 COL rtable.Description VAL Giorgio Armani Smooth Silk Eye Pencil - # 12 Brown 1.05g/0.037oz 	 0
 COL ltable.Product_id VAL 3726 COL ltable.Description VAL Dior diorshow mascara COL ltable.Color VAL Black 090 	  COL rtable.ID VAL AM1148 COL rtable.Color VAL 099 Kohl Black COL rtable.Description VAL Christian Dior 10ml/0.33oz Diorshow Black Out Mascara Waterproof - # 099 Kohl Black 	 0
 COL ltable.Product_id VAL 2713 COL ltable.Description VAL Shiseido the makeup powdery foundation COL ltable.Color VAL O20 Natural Light Ochre 	  COL rtable.ID VAL AM6312 COL rtable.Color VAL O20 Natural Light Ochre COL rtable.Description VAL Shiseido The Makeup Powdery Foundation O20 Natural Light Ochre 0.38 oz 	 1
 COL ltable.Product_id VAL 740 COL ltable.Description VAL CLINIQUE chubby stick shadow tint for eyes COL ltable.Color VAL Whopping Willow 	  COL rtable.ID VAL AM1551 COL rtable.Color VAL Big Blue COL rtable.Description VAL Clinique Chubby Stick Shadow Tint for Eyes Big Blue 0.1 oz 	 0
 COL ltable.Product_id VAL 2507 COL ltable.Description VAL Guerlain rose aux joues COL ltable.Color VAL Peach Boy 01 	  COL rtable.ID VAL AM5921 COL rtable.Color VAL Peach Boy COL rtable.Description VAL Guerlain Rose Aux Joues Blush Duo - # 01 Peach Boy - 6g/0.21oz 	 1
 COL ltable.Product_id VAL 9664 COL ltable.Description VAL Bite Beauty discovery set COL ltable.Color VAL nan 	  COL rtable.ID VAL AM0473 COL rtable.Color VAL nan COL rtable.Description VAL Bite Beauty Discovery Set 	 1
 COL ltable.Product_id VAL 2496 COL ltable.Description VAL Bobbi Brown corrector COL ltable.Color VAL Medium to Dark Bisque 	  COL rtable.ID VAL AM5757 COL rtable.Color VAL Light to Medium Bisque COL rtable.Description VAL Bobbi Brown Light to Medium Bisque Corrector .05 oz 	 0
 COL ltable.Product_id VAL 9864 COL ltable.Description VAL Bobbi Brown foundation stick COL ltable.Color VAL Warm Natural 	  COL rtable.ID VAL AM5089 COL rtable.Color VAL Warm Ivory COL rtable.Description VAL Exclusive Make Up Product By Bobbi Brown Foundation Stick - #1 Warm Ivory 9g/0.31oz 	 0
 COL ltable.Product_id VAL 2545 COL ltable.Description VAL MAKE UP FOR EVER aqua eyes COL ltable.Color VAL Light Taupe 24L 	  COL rtable.ID VAL AM5997 COL rtable.Color VAL Bronze 10L COL rtable.Description VAL Make Up For Ever Aqua Eyes Waterproof Eyeliner Pencil - #10L ( Bronze ) - 1.2g/0.04oz 	 0
 COL ltable.Product_id VAL 1565 COL ltable.Description VAL Guerlain kisskiss roselip COL ltable.Color VAL Wonder Violette R374 	  COL rtable.ID VAL AM3696 COL rtable.Color VAL Peach Party COL rtable.Description VAL Guerlain KissKiss Roselip Lip Balm - Peach Party R346 	 0
 COL ltable.Product_id VAL 805 COL ltable.Description VAL Guerlain terracotta bronzing powder COL ltable.Color VAL 4 	  COL rtable.ID VAL AM1775 COL rtable.Color VAL 1 COL rtable.Description VAL Terracotta Bronzing Powder ( Moisturising & Long Lasting ) - No. 01 - Guerlain - Powder - Terracotta Bronzing Powder ( Moisturising & Long Lasting ) - 10g/0.35oz 	 0
 COL ltable.Product_id VAL 863 COL ltable.Description VAL Blinc mascara amplified COL ltable.Color VAL Dark Brown 	  COL rtable.ID VAL AM1980 COL rtable.Color VAL Dark Brown COL rtable.Description VAL blinc Mascara Amplified 	 1
 COL ltable.Product_id VAL 9852 COL ltable.Description VAL Bobbi Brown foundation stick COL ltable.Color VAL Golden Honey 	  COL rtable.ID VAL AM1422 COL rtable.Color VAL Warm Sand COL rtable.Description VAL Bobbi Brown Foundation Stick Warm Sand # 2.5 Full Size (Box) 	 0
 COL ltable.Product_id VAL 2086 COL ltable.Description VAL AmorePacific color control cushion compact broad spectrum spf 50 COL ltable.Color VAL 204 Tan Gold 	  COL rtable.ID VAL AM4654 COL rtable.Color VAL 204 Tan Gold COL rtable.Description VAL AmorePacific Color Control Cushion Compact Broad Spectrum SPF 50+ 204 	 1
 COL ltable.Product_id VAL 973 COL ltable.Description VAL CLINIQUE chubby stick moisturizing lip colour balm COL ltable.Color VAL Voluptuous Violet 	  COL rtable.ID VAL AM2063 COL rtable.Color VAL Chunky Cherry COL rtable.Description VAL Clinique Chubby Stick Moisturizing Lip Colour Balm - 05 Chunky Cherry - Duo Pack (0.04 oz X 2 = 0.08 oz / 2.4 g) 	 0
 COL ltable.Product_id VAL 476 COL ltable.Description VAL NARS contour blush COL ltable.Color VAL Gienah 	  COL rtable.ID VAL AM0862 COL rtable.Color VAL Gienah COL rtable.Description VAL NARS Contour Blush Powder Duo Gienah 	 1
 COL ltable.Product_id VAL 421 COL ltable.Description VAL Too Faced melted liquified long wear lipstick COL ltable.Color VAL Melted Berry 	  COL rtable.ID VAL AM2514 COL rtable.Color VAL Melted Rainbow COL rtable.Description VAL Too Faced Melted Liquified Long Wear Lipstick - Melted Rainbow Size 0.4 Oz 	 0
 COL ltable.Product_id VAL 4289 COL ltable.Description VAL Laura Mercier secret brightener COL ltable.Color VAL #1 	  COL rtable.ID VAL AM2346 COL rtable.Color VAL #1 COL rtable.Description VAL Laura Mercier Secret Brightener - Secret Brightener #1, .05 oz. 	 1
 COL ltable.Product_id VAL 7654 COL ltable.Description VAL Smashbox be legendary lip gloss COL ltable.Color VAL Cognac 	  COL rtable.ID VAL AM4491 COL rtable.Color VAL Cognac COL rtable.Description VAL Smashbox Be Legendary Lip Gloss - Cognac 0.20oz (6ml) 	 1
 COL ltable.Product_id VAL 9862 COL ltable.Description VAL Bobbi Brown foundation stick COL ltable.Color VAL Warm Honey 	  COL rtable.ID VAL AM5089 COL rtable.Color VAL Warm Ivory COL rtable.Description VAL Exclusive Make Up Product By Bobbi Brown Foundation Stick - #1 Warm Ivory 9g/0.31oz 	 0
 COL ltable.Product_id VAL 9389 COL ltable.Description VAL Bobbi Brown bronzing powder COL ltable.Color VAL Medium 	  COL rtable.ID VAL AM5163 COL rtable.Color VAL Pink Peony COL rtable.Description VAL BOBBI BROWN Pink Peony Set :Pink Peony Illuminating Bronzing Powder +Mini Face Blender Brush . 	 0
 COL ltable.Product_id VAL 822 COL ltable.Description VAL Smashbox 24 hour cc spot concealer COL ltable.Color VAL Fair Light 	  COL rtable.ID VAL AM1947 COL rtable.Color VAL Medium Dark COL rtable.Description VAL SMASHBOX 24 Hour CC Spot Concealer Medium Dark - 100% Authentic 	 0
 COL ltable.Product_id VAL 8822 COL ltable.Description VAL tarte lipsurgence lip tint COL ltable.Color VAL Moody 	  COL rtable.ID VAL AM2778 COL rtable.Color VAL Energy COL rtable.Description VAL Tarte ENERGY LipSurgence Skintuitive Lip Tint (Mini) 	 0
 COL ltable.Product_id VAL 808 COL ltable.Description VAL Guerlain terracotta bronzing powder COL ltable.Color VAL 8 	  COL rtable.ID VAL AM1774 COL rtable.Color VAL 1 COL rtable.Description VAL Guerlain Terracotta Bronzing Powder, Moisturizing and Long Lasting, # 01, 0.35 Ounce 	 0
 COL ltable.Product_id VAL 8821 COL ltable.Description VAL tarte lipsurgence lip tint COL ltable.Color VAL Lovely 	  COL rtable.ID VAL AM2776 COL rtable.Color VAL Energy COL rtable.Description VAL Tarte Lipsurgence Skintuitive Lip Tint - Energy (.10 oz) 	 0
 COL ltable.Product_id VAL 8817 COL ltable.Description VAL tarte lipsurgence lip tint COL ltable.Color VAL Elite 	  COL rtable.ID VAL AM2778 COL rtable.Color VAL Energy COL rtable.Description VAL Tarte ENERGY LipSurgence Skintuitive Lip Tint (Mini) 	 0
 COL ltable.Product_id VAL 56 COL ltable.Description VAL Dior star concealer COL ltable.Color VAL 005 Mocha 	  COL rtable.ID VAL AM0076 COL rtable.Color VAL 002 Beige COL rtable.Description VAL Christian Dior Diorskin Star Sculpting Brightening Concealer - # 002 Beige Christian Dior Women - 0.2 Oz Concealer, 0.2 Ounce 	 0
 COL ltable.Product_id VAL 1102 COL ltable.Description VAL NARS makeup removing water COL ltable.Color VAL nan 	  COL rtable.ID VAL AM2305 COL rtable.Color VAL nan COL rtable.Description VAL NARS Makeup Removing Water - 200ml/6.7oz 	 1
 COL ltable.Product_id VAL 9973 COL ltable.Description VAL Smashbox try it kit COL ltable.Color VAL nan 	  COL rtable.ID VAL AM1437 COL rtable.Color VAL nan COL rtable.Description VAL Smashbox Try It Kit 	 1
 COL ltable.Product_id VAL 518 COL ltable.Description VAL Hourglass ambient lighting edit COL ltable.Color VAL nan 	  COL rtable.ID VAL AM0922 COL rtable.Color VAL nan COL rtable.Description VAL Hourglass Ambient Lighting Edit 	 1
 COL ltable.Product_id VAL 9386 COL ltable.Description VAL Bobbi Brown bronzing powder COL ltable.Color VAL Dark 	  COL rtable.ID VAL AM5163 COL rtable.Color VAL Pink Peony COL rtable.Description VAL BOBBI BROWN Pink Peony Set :Pink Peony Illuminating Bronzing Powder +Mini Face Blender Brush . 	 0
 COL ltable.Product_id VAL 1121 COL ltable.Description VAL Givenchy noir couture COL ltable.Color VAL 1 Black Satin 	  COL rtable.ID VAL AM2360 COL rtable.Color VAL 1 Black Satin COL rtable.Description VAL Givenchy Noir Couture Mascara # 1 Black Satin 4g 	 1
 COL ltable.Product_id VAL 1493 COL ltable.Description VAL CLINIQUE even better makeup spf 15 COL ltable.Color VAL Cream Caramel 	  COL rtable.ID VAL AM3660 COL rtable.Color VAL Vanilla COL rtable.Description VAL New 2013 Clinique Even Better Compact Makeup Spf 15 ~ VANILLA 	 0
 COL ltable.Product_id VAL 658 COL ltable.Description VAL Giorgio Armani luminous silk foundation COL ltable.Color VAL 10 	  COL rtable.ID VAL AM1328 COL rtable.Color VAL 19 COL rtable.Description VAL Giorgio Armani Luminous Silk Foundation # 10 30Ml/1Oz 	 0
 COL ltable.Product_id VAL 2545 COL ltable.Description VAL MAKE UP FOR EVER aqua eyes COL ltable.Color VAL Light Taupe 24L 	  COL rtable.ID VAL AM5999 COL rtable.Color VAL Fuschia Pink 13L COL rtable.Description VAL MAKE UP FOR EVER Aqua Eyes Fuschia Pink 13L 0.04 oz 	 0
 COL ltable.Product_id VAL 9858 COL ltable.Description VAL Bobbi Brown foundation stick COL ltable.Color VAL Sand 	  COL rtable.ID VAL AM1422 COL rtable.Color VAL Warm Sand COL rtable.Description VAL Bobbi Brown Foundation Stick Warm Sand # 2.5 Full Size (Box) 	 0
 COL ltable.Product_id VAL 822 COL ltable.Description VAL Smashbox 24 hour cc spot concealer COL ltable.Color VAL Fair Light 	  COL rtable.ID VAL AM1941 COL rtable.Color VAL Fair Light COL rtable.Description VAL Smashbox 24 Hour CC Spot Concealer .008 fl. oz. - Fair/Light 	 1
 COL ltable.Product_id VAL 4641 COL ltable.Description VAL Estee Lauder double wear stay in place makeup COL ltable.Color VAL Fresco 2C3 	  COL rtable.ID VAL AM4947 COL rtable.Color VAL 14 COL rtable.Description VAL Estee Lauder Double Wear Light Stay In Place Makeup SPF10 - # 14 (Intensity 5.0) 30ml/1oz 	 0
 COL ltable.Product_id VAL 2365 COL ltable.Description VAL Laura Mercier secret concealer COL ltable.Color VAL 2 	  COL rtable.ID VAL AM0742 COL rtable.Color VAL 2 COL rtable.Description VAL Laura Mercier Secret Concealer #2 2.2G/0.08Oz 	 1
