 COL ltable.Product_id VAL 1363 COL ltable.Description VAL Smashbox layer lash primer COL ltable.Color VAL Layer Lash Primer 	  COL rtable.ID VAL AM2797 COL rtable.Color VAL nan COL rtable.Description VAL Smashbox Layer Lash Primer by Smashbox 	 1
 COL ltable.Product_id VAL 2547 COL ltable.Description VAL MAKE UP FOR EVER aqua eyes COL ltable.Color VAL Matte Black 0L 	  COL rtable.ID VAL AM5988 COL rtable.Color VAL Back with Purle Highlights 6L COL rtable.Description VAL Make Up For Ever Aqua Eyes Waterproof Eyeliner Pencil - #6L (Black with Purple Highlights) - 1.2g/0.04oz 	 0
 COL ltable.Product_id VAL 7349 COL ltable.Description VAL NARS larger than life lip gloss COL ltable.Color VAL Spring Break 	  COL rtable.ID VAL AM1691 COL rtable.Color VAL Bright Cherry Red COL rtable.Description VAL Nars Larger Than Life Lip Gloss Color Norma - Bright Cherry Red 	 0
 COL ltable.Product_id VAL 880 COL ltable.Description VAL Shiseido foundation brush COL ltable.Color VAL nan 	  COL rtable.ID VAL AM2011 COL rtable.Color VAL nan COL rtable.Description VAL Shiseido The Makeup Perfect Foundation Brush For all formulas 	 1
 COL ltable.Product_id VAL 1122 COL ltable.Description VAL Givenchy noir couture COL ltable.Color VAL 2 Brown Satin 	  COL rtable.ID VAL AM2362 COL rtable.Color VAL 2 Brown Satin COL rtable.Description VAL Givenchy Noir Couture Mascara - # 1 Black Satin - 8g/0.28oz 	 1
 COL ltable.Product_id VAL 2118 COL ltable.Description VAL NARS bronzing powder COL ltable.Color VAL Laguna 	  COL rtable.ID VAL AM4670 COL rtable.Color VAL Casino COL rtable.Description VAL NARS Bronzing Powder Casino 	 0
 COL ltable.Product_id VAL 8822 COL ltable.Description VAL tarte lipsurgence lip tint COL ltable.Color VAL Moody 	  COL rtable.ID VAL AM2776 COL rtable.Color VAL Energy COL rtable.Description VAL Tarte Lipsurgence Skintuitive Lip Tint - Energy (.10 oz) 	 0
 COL ltable.Product_id VAL 662 COL ltable.Description VAL Giorgio Armani luminous silk foundation COL ltable.Color VAL 3 	  COL rtable.ID VAL AM1331 COL rtable.Color VAL 3.75 COL rtable.Description VAL GIORGIO ARMANI LUMINOUS SILK FOUNDATION # 3.75, 30ML, 1FL OZ 	 0
 COL ltable.Product_id VAL 4974 COL ltable.Description VAL Laura Mercier secret camouflage COL ltable.Color VAL SC-3 	  COL rtable.ID VAL AM5433 COL rtable.Color VAL SC-4 COL rtable.Description VAL Laura Mercier Secret Camouflage # Sc4 (For Medium To Golden Skin Tones) 5.92G/0.207Oz 	 0
 COL ltable.Product_id VAL 9577 COL ltable.Description VAL Giorgio Armani waterproof smooth silk eye pencil COL ltable.Color VAL Brown 	  COL rtable.ID VAL AM2148 COL rtable.Color VAL Brown COL rtable.Description VAL Giorgio Armani Waterproof Smooth Silk Eye Pencil - # 02 (Brown) 1.2g/0.04oz 	 1
 COL ltable.Product_id VAL 1132 COL ltable.Description VAL Dior diorskin nude skin perfecting hydrating concealer COL ltable.Color VAL Ivory 001 	  COL rtable.ID VAL AM2393 COL rtable.Color VAL Ivory 001 COL rtable.Description VAL Christian Dior Diorskin Nude Skin Perfecting Hydrating Concealer # 001 Ivory 	 1
 COL ltable.Product_id VAL 2245 COL ltable.Description VAL CLINIQUE brow shaper COL ltable.Color VAL Charcoaled  	  COL rtable.ID VAL AM5017 COL rtable.Color VAL Charcoaled  COL rtable.Description VAL Clinique Brow Shaper 05 Charcoaled 	 1
 COL ltable.Product_id VAL 9861 COL ltable.Description VAL Bobbi Brown foundation stick COL ltable.Color VAL Warm Beige 	  COL rtable.ID VAL AM1422 COL rtable.Color VAL Warm Sand COL rtable.Description VAL Bobbi Brown Foundation Stick Warm Sand # 2.5 Full Size (Box) 	 0
 COL ltable.Product_id VAL 1627 COL ltable.Description VAL Hourglass extreme sheen high shine lip gloss COL ltable.Color VAL Child 	  COL rtable.ID VAL AM3835 COL rtable.Color VAL Truth COL rtable.Description VAL Hourglass Extreme Sheen High Shine Lip Gloss Truth 	 0
 COL ltable.Product_id VAL 9386 COL ltable.Description VAL Bobbi Brown bronzing powder COL ltable.Color VAL Dark 	  COL rtable.ID VAL AM4360 COL rtable.Color VAL Tawny Brown COL rtable.Description VAL Bobbi Brown Bronzing Powder - Tawny Brown 0.28 Oz, (BNIB) 	 0
 COL ltable.Product_id VAL 9864 COL ltable.Description VAL Bobbi Brown foundation stick COL ltable.Color VAL Warm Natural 	  COL rtable.ID VAL AM1422 COL rtable.Color VAL Warm Sand COL rtable.Description VAL Bobbi Brown Foundation Stick Warm Sand # 2.5 Full Size (Box) 	 0
 COL ltable.Product_id VAL 9844 COL ltable.Description VAL Bobbi Brown foundation stick COL ltable.Color VAL Almond 	  COL rtable.ID VAL AM5089 COL rtable.Color VAL Warm Ivory COL rtable.Description VAL Exclusive Make Up Product By Bobbi Brown Foundation Stick - #1 Warm Ivory 9g/0.31oz 	 0
 COL ltable.Product_id VAL 4484 COL ltable.Description VAL Laura Mercier lip glace COL ltable.Color VAL Bare Beige 	  COL rtable.ID VAL AM6157 COL rtable.Color VAL Bare Beige COL rtable.Description VAL Laura Mercier Lip Glace - Bare Beige 	 1
 COL ltable.Product_id VAL 374 COL ltable.Description VAL Urban Decay naked palette COL ltable.Color VAL nan 	  COL rtable.ID VAL AM0523 COL rtable.Color VAL nan COL rtable.Description VAL Urban Decay Naked Basics Palette 	 1
 COL ltable.Product_id VAL 10695 COL ltable.Description VAL CLINIQUE high impact mascara COL ltable.Color VAL Black  	  COL rtable.ID VAL AM1590 COL rtable.Color VAL Green COL rtable.Description VAL Clinique Eye Makeup Expert (1x Quickliner, 1x Chubby Stick Shadow, 1x High Impact Mascara) - Green - 3pcs 	 0
 COL ltable.Product_id VAL 1360 COL ltable.Description VAL Shiseido lacquer gloss COL ltable.Color VAL VI708 Phantom 	  COL rtable.ID VAL AM2766 COL rtable.Color VAL BR301 COL rtable.Description VAL Shiseido Lip Care 0.25 Oz Lacquer Gloss - # Br301 (Mocha) For Women 	 0
 COL ltable.Product_id VAL 1659 COL ltable.Description VAL Bobbi Brown long wear even finish foundation spf 15 COL ltable.Color VAL Warm Walnut 	  COL rtable.ID VAL AM3837 COL rtable.Color VAL Warm Almond COL rtable.Description VAL Bobbi Brown Long Wear Even Finish Foundation SPF 15 - # 6.5 Warm Almond - 30ml/1oz 	 0
 COL ltable.Product_id VAL 9861 COL ltable.Description VAL Bobbi Brown foundation stick COL ltable.Color VAL Warm Beige 	  COL rtable.ID VAL AM5089 COL rtable.Color VAL Warm Ivory COL rtable.Description VAL Exclusive Make Up Product By Bobbi Brown Foundation Stick - #1 Warm Ivory 9g/0.31oz 	 0
 COL ltable.Product_id VAL 4640 COL ltable.Description VAL Estee Lauder double wear stay in place makeup COL ltable.Color VAL Ecru 1N2 	  COL rtable.ID VAL AM5007 COL rtable.Color VAL 13 COL rtable.Description VAL Estee Lauder By Estee Lauder - Double Wear Light Stay In Place Makeup Spf10 - # 13 ( Intensity 4.0 ) --30ml/1oz... 	 0
 COL ltable.Product_id VAL 9858 COL ltable.Description VAL Bobbi Brown foundation stick COL ltable.Color VAL Sand 	  COL rtable.ID VAL AM5089 COL rtable.Color VAL Warm Ivory COL rtable.Description VAL Exclusive Make Up Product By Bobbi Brown Foundation Stick - #1 Warm Ivory 9g/0.31oz 	 0
 COL ltable.Product_id VAL 362 COL ltable.Description VAL MAKE UP FOR EVER artist plexi gloss COL ltable.Color VAL 306 	  COL rtable.ID VAL AM0586 COL rtable.Color VAL 406 COL rtable.Description VAL Make up for Ever Artist Plexi Gloss Lip Lacquer 406 - Burgundy (Opaque) 	 0
 COL ltable.Product_id VAL 2489 COL ltable.Description VAL Bobbi Brown corrector COL ltable.Color VAL Bisque 	  COL rtable.ID VAL AM5757 COL rtable.Color VAL Light to Medium Bisque COL rtable.Description VAL Bobbi Brown Light to Medium Bisque Corrector .05 oz 	 0
 COL ltable.Product_id VAL 2439 COL ltable.Description VAL CLINIQUE line smoothing concealer COL ltable.Color VAL Deep 	  COL rtable.ID VAL AM5635 COL rtable.Color VAL Deep Honey COL rtable.Description VAL Clinique Line Smoothing Concealer 10 Deep Honey 	 0
 COL ltable.Product_id VAL 9664 COL ltable.Description VAL Bite Beauty discovery set COL ltable.Color VAL nan 	  COL rtable.ID VAL AM2028 COL rtable.Color VAL nan COL rtable.Description VAL Bite Beauty Discovery Set 	 1
 COL ltable.Product_id VAL 518 COL ltable.Description VAL Hourglass ambient lighting edit COL ltable.Color VAL nan 	  COL rtable.ID VAL AM4056 COL rtable.Color VAL nan COL rtable.Description VAL Hourglass Ambient Lighting Edit 	 1
 COL ltable.Product_id VAL 8819 COL ltable.Description VAL tarte lipsurgence lip tint COL ltable.Color VAL Glitzy 	  COL rtable.ID VAL AM2778 COL rtable.Color VAL Energy COL rtable.Description VAL Tarte ENERGY LipSurgence Skintuitive Lip Tint (Mini) 	 0
 COL ltable.Product_id VAL 2494 COL ltable.Description VAL Bobbi Brown corrector COL ltable.Color VAL Light Peach 	  COL rtable.ID VAL AM5757 COL rtable.Color VAL Light to Medium Bisque COL rtable.Description VAL Bobbi Brown Light to Medium Bisque Corrector .05 oz 	 0
 COL ltable.Product_id VAL 39 COL ltable.Description VAL Shiseido veiled rouge COL ltable.Color VAL BE301 Carrera 	  COL rtable.ID VAL AM0062 COL rtable.Color VAL PK304 Skyglow COL rtable.Description VAL Shiseido Veiled Rouge Lipstick - PK304 Skyglow 	 0
 COL ltable.Product_id VAL 8406 COL ltable.Description VAL Bobbi Brown eye shadow COL ltable.Color VAL Toast 	  COL rtable.ID VAL AM4365 COL rtable.Color VAL nan COL rtable.Description VAL Bobbi Brown Pretty Powerful Palette - Pretty : 4 Eye Shadow / Pink Blush / 3 Lip Gloss by Kodiake 	 0
 COL ltable.Product_id VAL 6016 COL ltable.Description VAL Dior diorskin nude skin glowing makeup spf 15 COL ltable.Color VAL Dark Brown 070 	  COL rtable.ID VAL AM1453 COL rtable.Color VAL Medium Beige 030 COL rtable.Description VAL Dior Diorskin Nude Skin Glowing Makeup SPF 15 - # 030 Medium Beige - 30ml/1oz (BNIB) 	 0
 COL ltable.Product_id VAL 9386 COL ltable.Description VAL Bobbi Brown bronzing powder COL ltable.Color VAL Dark 	  COL rtable.ID VAL AM4360 COL rtable.Color VAL Tawny Brown COL rtable.Description VAL Bobbi Brown Bronzing Powder - Tawny Brown 0.28 Oz, (BNIB) 	 0
 COL ltable.Product_id VAL 807 COL ltable.Description VAL Guerlain terracotta bronzing powder COL ltable.Color VAL 7 	  COL rtable.ID VAL AM1774 COL rtable.Color VAL 1 COL rtable.Description VAL Guerlain Terracotta Bronzing Powder, Moisturizing and Long Lasting, # 01, 0.35 Ounce 	 0
 COL ltable.Product_id VAL 378 COL ltable.Description VAL Giorgio Armani lasting silk uv foundation spf 20 COL ltable.Color VAL 5 	  COL rtable.ID VAL AM0589 COL rtable.Color VAL nan COL rtable.Description VAL Giorgio Armani 'Lasting Silk' UV Foundation SPF 20 	 0
 COL ltable.Product_id VAL 2248 COL ltable.Description VAL CLINIQUE brow shaper COL ltable.Color VAL Wheat  	  COL rtable.ID VAL AM5017 COL rtable.Color VAL Charcoaled COL rtable.Description VAL Clinique Brow Shaper 05 Charcoaled 	 0
 COL ltable.Product_id VAL 511 COL ltable.Description VAL Dior diorskin forever compact flawless perfection fusion wear makeup spf 25 COL ltable.Color VAL Ivory 010 	  COL rtable.ID VAL AM0941 COL rtable.Color VAL Medium Beige 030 COL rtable.Description VAL Christian Dior Diorskin Forever Compact Flawless Perfection Fusion Wear Makeup SPF 25 Medium Beige 030 	 0
 COL ltable.Product_id VAL 9929 COL ltable.Description VAL COVER FX blotting powder COL ltable.Color VAL Medium 	  COL rtable.ID VAL AM0943 COL rtable.Color VAL Medium COL rtable.Description VAL COVER FX Matte Oil Absorbing Primer & Blotting Powder - Medium 	 1
 COL ltable.Product_id VAL 1115 COL ltable.Description VAL Too Faced sweethearts perfect flush blush COL ltable.Color VAL Candy Glow 	  COL rtable.ID VAL AM2338 COL rtable.Color VAL Candy Glow COL rtable.Description VAL Too Faced Sweethearts Perfect Flush Blush - Candy Glow Blush 	 1
 COL ltable.Product_id VAL 9041 COL ltable.Description VAL stila illuminating powder foundation COL ltable.Color VAL 10 Watts 	  COL rtable.ID VAL AM1645 COL rtable.Color VAL nan COL rtable.Description VAL stila Illuminating Powder Foundation Refillable Compact 	 0
 COL ltable.Product_id VAL 4974 COL ltable.Description VAL Laura Mercier secret camouflage COL ltable.Color VAL SC-3 	  COL rtable.ID VAL AM5479 COL rtable.Color VAL SC7 COL rtable.Description VAL Makeup - Laura Mercier - Secret Camouflage - # SC7 (For Deep with Honey Skin Tones) 5.92g/0.207oz 	 0
 COL ltable.Product_id VAL 3726 COL ltable.Description VAL Dior diorshow mascara COL ltable.Color VAL Black 090 	  COL rtable.ID VAL AM1149 COL rtable.Color VAL 099 Kohl Black COL rtable.Description VAL Dior Diorshow Black Out Mascara Size 0.33 Oz Color Kohl Black 099 - Rich Black 	 0
 COL ltable.Product_id VAL 375 COL ltable.Description VAL Giorgio Armani lasting silk uv foundation spf 20 COL ltable.Color VAL 2 	  COL rtable.ID VAL AM0589 COL rtable.Color VAL nan COL rtable.Description VAL Giorgio Armani 'Lasting Silk' UV Foundation SPF 20 	 0
 COL ltable.Product_id VAL 384 COL ltable.Description VAL Urban Decay naked2 COL ltable.Color VAL nan 	  COL rtable.ID VAL AM0658 COL rtable.Color VAL nan COL rtable.Description VAL Urban Decay Naked2 	 1
 COL ltable.Product_id VAL 1487 COL ltable.Description VAL CLINIQUE even better makeup spf 15 COL ltable.Color VAL Amber 	  COL rtable.ID VAL AM3474 COL rtable.Color VAL Amber COL rtable.Description VAL Clinique Even Better Makeup Broad Spectrum Spf 15 Evens and Corrects 13 Amber (O/d-g)15ml 	 1
 COL ltable.Product_id VAL 9664 COL ltable.Description VAL Bite Beauty discovery set COL ltable.Color VAL nan 	  COL rtable.ID VAL AM4609 COL rtable.Color VAL nan COL rtable.Description VAL Bite Beauty Discovery Set 	 1
 COL ltable.Product_id VAL 8407 COL ltable.Description VAL Bobbi Brown eye shadow COL ltable.Color VAL White 	  COL rtable.ID VAL AM4365 COL rtable.Color VAL nan COL rtable.Description VAL Bobbi Brown Pretty Powerful Palette - Pretty : 4 Eye Shadow / Pink Blush / 3 Lip Gloss by Kodiake 	 0
 COL ltable.Product_id VAL 9046 COL ltable.Description VAL stila illuminating powder foundation COL ltable.Color VAL 60 Watts 	  COL rtable.ID VAL AM1645 COL rtable.Color VAL nan COL rtable.Description VAL stila Illuminating Powder Foundation Refillable Compact 	 0
 COL ltable.Product_id VAL 691 COL ltable.Description VAL Bobbi Brown foundation brush COL ltable.Color VAL nan 	  COL rtable.ID VAL AM1419 COL rtable.Color VAL nan COL rtable.Description VAL Bobbi Brown Foundation Brush 	 1
 COL ltable.Product_id VAL 4975 COL ltable.Description VAL Laura Mercier secret camouflage COL ltable.Color VAL SC-4 	  COL rtable.ID VAL AM0734 COL rtable.Color VAL nan COL rtable.Description VAL Laura Mercier Secret Camouflage Brush - Pull Apart - 	 0
 COL ltable.Product_id VAL 1150 COL ltable.Description VAL Smashbox brow tech COL ltable.Color VAL Dark Brown 	  COL rtable.ID VAL AM2400 COL rtable.Color VAL Dark Brown COL rtable.Description VAL Smashbox Brow Tech Gloss Stick - Dark Brown 	 1
 COL ltable.Product_id VAL 1645 COL ltable.Description VAL Bobbi Brown long wear even finish foundation spf 15 COL ltable.Color VAL Espresso 	  COL rtable.ID VAL AM3843 COL rtable.Color VAL Chestnut COL rtable.Description VAL Bobbi Brown Long Wear Even Finish Foundation SPF 15 - # 9 Chestnut 30ml/1oz 	 0
 COL ltable.Product_id VAL 1499 COL ltable.Description VAL CLINIQUE even better makeup spf 15 COL ltable.Color VAL Ginger 	  COL rtable.ID VAL AM3582 COL rtable.Color VAL Ivory COL rtable.Description VAL Clinique Even Better Makeup SPF 15 #03 Ivory 0.15oz/15ml (Promo Size) 	 0
 COL ltable.Product_id VAL 1896 COL ltable.Description VAL Bobbi Brown blush COL ltable.Color VAL Pastel Peach 	  COL rtable.ID VAL AM0309 COL rtable.Color VAL Desert Rose COL rtable.Description VAL Bobbi Brown Bobbi Brown Blush - Desert Rose 	 0
 COL ltable.Product_id VAL 1691 COL ltable.Description VAL Hourglass ambient lighting palette COL ltable.Color VAL nan 	  COL rtable.ID VAL AM4059 COL rtable.Color VAL nan COL rtable.Description VAL Hourglass Ambient Lighting Palette 	 1
 COL ltable.Product_id VAL 1018 COL ltable.Description VAL Shiseido shimmering rouge COL ltable.Color VAL RS619 Venus 	  COL rtable.ID VAL AM2199 COL rtable.Color VAL OR405 COL rtable.Description VAL Shiseido Shimmering Rouge OR 405 	 0
 COL ltable.Product_id VAL 9852 COL ltable.Description VAL Bobbi Brown foundation stick COL ltable.Color VAL Golden Honey 	  COL rtable.ID VAL AM5089 COL rtable.Color VAL Warm Ivory COL rtable.Description VAL Exclusive Make Up Product By Bobbi Brown Foundation Stick - #1 Warm Ivory 9g/0.31oz 	 0
 COL ltable.Product_id VAL 807 COL ltable.Description VAL Guerlain terracotta bronzing powder COL ltable.Color VAL 7 	  COL rtable.ID VAL AM1775 COL rtable.Color VAL 1 COL rtable.Description VAL Terracotta Bronzing Powder ( Moisturising & Long Lasting ) - No. 01 - Guerlain - Powder - Terracotta Bronzing Powder ( Moisturising & Long Lasting ) - 10g/0.35oz 	 0
 COL ltable.Product_id VAL 9405 COL ltable.Description VAL Laura Mercier eye colour COL ltable.Color VAL Plum Smoke 	  COL rtable.ID VAL AM4110 COL rtable.Color VAL nan COL rtable.Description VAL Laura Mercier Artists Palette For Eyes & Cheeks (8x Eye Colour, 1x Highlighter) - 	 0
 COL ltable.Product_id VAL 862 COL ltable.Description VAL Blinc mascara amplified COL ltable.Color VAL Black 	  COL rtable.ID VAL AM1974 COL rtable.Color VAL Black COL rtable.Description VAL blinc Mascara Amplified 	 1
 COL ltable.Product_id VAL 9230 COL ltable.Description VAL Hourglass ambient lighting blush COL ltable.Color VAL Mood Exposure 	  COL rtable.ID VAL AM4058 COL rtable.Color VAL nan COL rtable.Description VAL Hourglass Ambient Lighting Blush Palette 2014 	 0
 COL ltable.Product_id VAL 662 COL ltable.Description VAL Giorgio Armani luminous silk foundation COL ltable.Color VAL 3 	  COL rtable.ID VAL AM1332 COL rtable.Color VAL nan COL rtable.Description VAL Giorgio Armani 'Luminous Silk' Foundation 	 0
 COL ltable.Product_id VAL 9929 COL ltable.Description VAL COVER FX blotting powder COL ltable.Color VAL Medium 	  COL rtable.ID VAL AM0943 COL rtable.Color VAL Medium COL rtable.Description VAL COVER FX Matte Oil Absorbing Primer & Blotting Powder - Medium 	 1
 COL ltable.Product_id VAL 1659 COL ltable.Description VAL Bobbi Brown long wear even finish foundation spf 15 COL ltable.Color VAL Warm Walnut 	  COL rtable.ID VAL AM3843 COL rtable.Color VAL Chestnut COL rtable.Description VAL Bobbi Brown Long Wear Even Finish Foundation SPF 15 - # 9 Chestnut 30ml/1oz 	 0
 COL ltable.Product_id VAL 3728 COL ltable.Description VAL Dior diorshow mascara COL ltable.Color VAL Brown 698 	  COL rtable.ID VAL AM1148 COL rtable.Color VAL 099 Kohl Black COL rtable.Description VAL Christian Dior 10ml/0.33oz Diorshow Black Out Mascara Waterproof - # 099 Kohl Black 	 0
 COL ltable.Product_id VAL 863 COL ltable.Description VAL Blinc mascara amplified COL ltable.Color VAL Dark Brown 	  COL rtable.ID VAL AM1974 COL rtable.Color VAL Black COL rtable.Description VAL blinc Mascara Amplified 	 0
 COL ltable.Product_id VAL 9857 COL ltable.Description VAL Bobbi Brown foundation stick COL ltable.Color VAL Porcelain 	  COL rtable.ID VAL AM1422 COL rtable.Color VAL Warm Sand COL rtable.Description VAL Bobbi Brown Foundation Stick Warm Sand # 2.5 Full Size (Box) 	 0
 COL ltable.Product_id VAL 2711 COL ltable.Description VAL Shiseido the makeup powdery foundation COL ltable.Color VAL I40 Natural Fair Ivory 	  COL rtable.ID VAL AM6300 COL rtable.Color VAL I40 Natural Fair Ivory COL rtable.Description VAL Shiseido The Makeup Powdery Foundation I40 - I 40 (Natural Fair Ivory) REFILL Full Size 11 g / .38 oz. In Retail Box. LIMITED EDITION - NO SPF 	 1
 COL ltable.Product_id VAL 675 COL ltable.Description VAL Giorgio Armani luminous silk foundation COL ltable.Color VAL 6.5 	  COL rtable.ID VAL AM1374 COL rtable.Color VAL 6.5 COL rtable.Description VAL Giorgio Armani Luminous Silk Foundation - # 6.5 Tawny - 30ml/1oz 	 1
 COL ltable.Product_id VAL 2117 COL ltable.Description VAL NARS bronzing powder COL ltable.Color VAL Casino 	  COL rtable.ID VAL AM4671 COL rtable.Color VAL Casino COL rtable.Description VAL Bronzing Powder - Casino 8g/0.28oz by NARS 	 1
 COL ltable.Product_id VAL 9862 COL ltable.Description VAL Bobbi Brown foundation stick COL ltable.Color VAL Warm Honey 	  COL rtable.ID VAL AM1422 COL rtable.Color VAL Warm Sand COL rtable.Description VAL Bobbi Brown Foundation Stick Warm Sand # 2.5 Full Size (Box) 	 0
 COL ltable.Product_id VAL 9042 COL ltable.Description VAL stila illuminating powder foundation COL ltable.Color VAL 20 Watts 	  COL rtable.ID VAL AM1645 COL rtable.Color VAL nan COL rtable.Description VAL stila Illuminating Powder Foundation Refillable Compact 	 0
 COL ltable.Product_id VAL 52 COL ltable.Description VAL Dior star concealer COL ltable.Color VAL 001 Ivory 	  COL rtable.ID VAL AM0075 COL rtable.Color VAL Ivory 001 COL rtable.Description VAL Dior DiorSkin Star Concealer Ivory 001 	 1
 COL ltable.Product_id VAL 1150 COL ltable.Description VAL Smashbox brow tech COL ltable.Color VAL Dark Brown 	  COL rtable.ID VAL AM1987 COL rtable.Color VAL Gold Shimmer COL rtable.Description VAL Smashbox Brow Tech Highlight Stick Gold Shimmer 0.01oz 	 0
 COL ltable.Product_id VAL 2492 COL ltable.Description VAL Bobbi Brown corrector COL ltable.Color VAL Deep Bisque 	  COL rtable.ID VAL AM5757 COL rtable.Color VAL Light to Medium Bisque COL rtable.Description VAL Bobbi Brown Light to Medium Bisque Corrector .05 oz 	 0
 COL ltable.Product_id VAL 1515 COL ltable.Description VAL CLINIQUE even better makeup spf 15 COL ltable.Color VAL Vanilla 	  COL rtable.ID VAL AM3661 COL rtable.Color VAL Vanilla COL rtable.Description VAL Clinique Even Better Compact Makeup SPF 15 - # 14 Vanilla (MF-G) 10g/0.35oz 	 1
 COL ltable.Product_id VAL 728 COL ltable.Description VAL CLINIQUE chubby stick shadow tint for eyes COL ltable.Color VAL Curvaceous Coal 	  COL rtable.ID VAL AM6343 COL rtable.Color VAL Ample Amber COL rtable.Description VAL Clinique Chubby Stick Ample Amber Shadow Tint for Eyes Ample Amber 04 Full Size New in Box 	 0
 COL ltable.Product_id VAL 1494 COL ltable.Description VAL CLINIQUE even better makeup spf 15 COL ltable.Color VAL Cream Chamois 	  COL rtable.ID VAL AM3474 COL rtable.Color VAL Ivory COL rtable.Description VAL Clinique Even Better Makeup Broad Spectrum Spf 15 Evens and Corrects 13 Amber (O/d-g)15ml 	 0
 COL ltable.Product_id VAL 930 COL ltable.Description VAL tarte amazonian clay volumizing brow powder COL ltable.Color VAL Blonde 	  COL rtable.ID VAL AM2051 COL rtable.Color VAL Blonde COL rtable.Description VAL TARTE Amazonian Clay Volumizing Brow Powder (Blonde) 	 1
 COL ltable.Product_id VAL 659 COL ltable.Description VAL Giorgio Armani luminous silk foundation COL ltable.Color VAL 11.5 	  COL rtable.ID VAL AM1336 COL rtable.Color VAL nan COL rtable.Description VAL Giorgio Armani 'Luminous Silk' Foundation 	 0
 COL ltable.Product_id VAL 41 COL ltable.Description VAL Shiseido veiled rouge COL ltable.Color VAL PK304 Skyglow 	  COL rtable.ID VAL AM0062 COL rtable.Color VAL PK304 Skyglow COL rtable.Description VAL Shiseido Veiled Rouge Lipstick - PK304 Skyglow 	 1
 COL ltable.Product_id VAL 531 COL ltable.Description VAL Dior airflash matte touch COL ltable.Color VAL nan 	  COL rtable.ID VAL AM0953 COL rtable.Color VAL nan COL rtable.Description VAL Dior Airflash Matte Touch Long-Lasting Airy Powder Finishing Spray 	 0
 COL ltable.Product_id VAL 8819 COL ltable.Description VAL tarte lipsurgence lip tint COL ltable.Color VAL Glitzy 	  COL rtable.ID VAL AM2776 COL rtable.Color VAL Energy COL rtable.Description VAL Tarte Lipsurgence Skintuitive Lip Tint - Energy (.10 oz) 	 0
 COL ltable.Product_id VAL 6958 COL ltable.Description VAL Dior diorshow waterproof mascara COL ltable.Color VAL Catwalk Black 	  COL rtable.ID VAL AM1148 COL rtable.Color VAL 099 Kohl Black COL rtable.Description VAL Christian Dior 10ml/0.33oz Diorshow Black Out Mascara Waterproof - # 099 Kohl Black 	 0
 COL ltable.Product_id VAL 1653 COL ltable.Description VAL Bobbi Brown long wear even finish foundation spf 15 COL ltable.Color VAL Warm Almond 	  COL rtable.ID VAL AM3945 COL rtable.Color VAL Warm Walnut COL rtable.Description VAL Bobbi Brown Long Wear Even Finish Foundation SPF 15 - # 7.5 Warm Walnut - 30ml/1oz 	 0
 COL ltable.Product_id VAL 812 COL ltable.Description VAL Dior diorshow iconic mascara COL ltable.Color VAL Chestnut 	  COL rtable.ID VAL AM1867 COL rtable.Color VAL 698 Chestnut COL rtable.Description VAL CHRISTIAN DIOR by Christian Dior DiorShow Iconic High Definition Lash Curler Mascara - #698 Chestnut --10ml/0.33oz for WOMEN 	 1
 COL ltable.Product_id VAL 9860 COL ltable.Description VAL Bobbi Brown foundation stick COL ltable.Color VAL Warm Almond 	  COL rtable.ID VAL AM1422 COL rtable.Color VAL Warm Sand COL rtable.Description VAL Bobbi Brown Foundation Stick Warm Sand # 2.5 Full Size (Box) 	 0
 COL ltable.Product_id VAL 2503 COL ltable.Description VAL Bobbi Brown shimmer blush COL ltable.Color VAL Coral 	  COL rtable.ID VAL AM5911 COL rtable.Color VAL Pink Coral COL rtable.Description VAL Bobbi Brown Shimmer Blush Pink Coral 	 0
 COL ltable.Product_id VAL 1604 COL ltable.Description VAL NARS all day luminous weightless foundation COL ltable.Color VAL Barcelona 	  COL rtable.ID VAL AM3758 COL rtable.Color VAL Barcelona COL rtable.Description VAL NARS All Day Luminous Weightless Foundation, shade=Barcelona 	 1
 COL ltable.Product_id VAL 2493 COL ltable.Description VAL Bobbi Brown corrector COL ltable.Color VAL Light Bisque 	  COL rtable.ID VAL AM5759 COL rtable.Color VAL Bisque COL rtable.Description VAL BOBBI BROWN Corrector - Bisque 	 0
 COL ltable.Product_id VAL 4782 COL ltable.Description VAL Estee Lauder pure color envy sculpting lipstick COL ltable.Color VAL Tumultuous Pink 	  COL rtable.ID VAL AM0721 COL rtable.Color VAL Surreal Sun COL rtable.Description VAL EstEEe Lauder Pure Color Envy Shine Sculpting Shine Lipstick 320 Surreal Sun, 0.1oz, 3.1g by Estee Lauder 	 0
 COL ltable.Product_id VAL 4752 COL ltable.Description VAL Ecobrow defining wax COL ltable.Color VAL Liz 	  COL rtable.ID VAL AM3681 COL rtable.Color VAL Penelope COL rtable.Description VAL EcoBrow - All Natural Eyebrow Defining Wax (Penelope) 	 0
 COL ltable.Product_id VAL 1654 COL ltable.Description VAL Bobbi Brown long wear even finish foundation spf 15 COL ltable.Color VAL Warm Beige 	  COL rtable.ID VAL AM3837 COL rtable.Color VAL Warm Almond COL rtable.Description VAL Bobbi Brown Long Wear Even Finish Foundation SPF 15 - # 6.5 Warm Almond - 30ml/1oz 	 0
 COL ltable.Product_id VAL 2708 COL ltable.Description VAL Shiseido the makeup powdery foundation COL ltable.Color VAL B60 Natural Deep Beige 	  COL rtable.ID VAL AM6267 COL rtable.Color VAL B60 Natural Deep Beige COL rtable.Description VAL Shiseido The Makeup Powdery Foundation B60 Natural Deep Beige 0.38 oz 	 1
 COL ltable.Product_id VAL 9862 COL ltable.Description VAL Bobbi Brown foundation stick COL ltable.Color VAL Warm Honey 	  COL rtable.ID VAL AM5089 COL rtable.Color VAL Warm Ivory COL rtable.Description VAL Exclusive Make Up Product By Bobbi Brown Foundation Stick - #1 Warm Ivory 9g/0.31oz 	 0
 COL ltable.Product_id VAL 6015 COL ltable.Description VAL Dior diorskin nude skin glowing makeup spf 15 COL ltable.Color VAL Dark Beige 050 	  COL rtable.ID VAL AM1472 COL rtable.Color VAL Light Beige 020 COL rtable.Description VAL CHRISTIAN DIOR by Christian Dior Diorskin Nude Skin Glowing Makeup SPF 15 - # 020 Light Beige --30m 	 0
 COL ltable.Product_id VAL 1570 COL ltable.Description VAL MAKE UP FOR EVER pro finish multi use powder foundation COL ltable.Color VAL 118 Neutral Beige 	  COL rtable.ID VAL AM3738 COL rtable.Color VAL Neutral Amber COL rtable.Description VAL Make Up For Ever Pro Finish Multi Use Powder Foundation # 173 Neutral Amber 10G/0.35Oz 	 0
 COL ltable.Product_id VAL 7658 COL ltable.Description VAL Smashbox be legendary lip gloss COL ltable.Color VAL Melondrama 	  COL rtable.ID VAL AM4508 COL rtable.Color VAL Melondrama COL rtable.Description VAL Smashbox Be Legendary Lip Gloss - Melondrama 0.20oz (6ml) 	 1
 COL ltable.Product_id VAL 2547 COL ltable.Description VAL MAKE UP FOR EVER aqua eyes COL ltable.Color VAL Matte Black 0L 	  COL rtable.ID VAL AM5989 COL rtable.Color VAL Bronze Green 5L COL rtable.Description VAL MAKE UP FOR EVER Aqua Eyes Bronze Green 5L 0.04 oz 	 0
 COL ltable.Product_id VAL 2117 COL ltable.Description VAL NARS bronzing powder COL ltable.Color VAL Casino 	  COL rtable.ID VAL AM4670 COL rtable.Color VAL Casino COL rtable.Description VAL NARS Bronzing Powder Casino 	 1
 COL ltable.Product_id VAL 6459 COL ltable.Description VAL NARS brow gel COL ltable.Color VAL Piraeus 	  COL rtable.ID VAL AM1627 COL rtable.Color VAL Piraeus COL rtable.Description VAL NARS Brow Gel - Piraeus - 7ml/0.21oz 	 1
 COL ltable.Product_id VAL 10556 COL ltable.Description VAL NARS lip gloss COL ltable.Color VAL Chihuahua 	  COL rtable.ID VAL AM4689 COL rtable.Color VAL nan COL rtable.Description VAL NARS Lose Yourself Blush/Bronzing Powder Duo & Lip Gloss Set Lose Yourself Blush/Bronzing Powder Duo & Lip Gloss Set 	 0
 COL ltable.Product_id VAL 519 COL ltable.Description VAL COVER FX powder brush COL ltable.Color VAL nan 	  COL rtable.ID VAL AM0944 COL rtable.Color VAL nan COL rtable.Description VAL COVER FX Powder Brush 	 1
 COL ltable.Product_id VAL 1112 COL ltable.Description VAL NARS kudoki kabuki brush COL ltable.Color VAL nan 	  COL rtable.ID VAL AM2333 COL rtable.Color VAL nan COL rtable.Description VAL NARS Kudoki Kabuki Brush 	 1
 COL ltable.Product_id VAL 9854 COL ltable.Description VAL Bobbi Brown foundation stick COL ltable.Color VAL Honey 	  COL rtable.ID VAL AM5089 COL rtable.Color VAL Warm Ivory COL rtable.Description VAL Exclusive Make Up Product By Bobbi Brown Foundation Stick - #1 Warm Ivory 9g/0.31oz 	 0
 COL ltable.Product_id VAL 53 COL ltable.Description VAL Dior star concealer COL ltable.Color VAL 002 Beige 	  COL rtable.ID VAL AM0076 COL rtable.Color VAL 002 Beige COL rtable.Description VAL Christian Dior Diorskin Star Sculpting Brightening Concealer - # 002 Beige Christian Dior Women - 0.2 Oz Concealer, 0.2 Ounce 	 1
 COL ltable.Product_id VAL 594 COL ltable.Description VAL Dior glow maximizer primer COL ltable.Color VAL 1 	  COL rtable.ID VAL AM1106 COL rtable.Color VAL 1 COL rtable.Description VAL Dior Glow Maximizer Light Boosting Primer 	 1
 COL ltable.Product_id VAL 9844 COL ltable.Description VAL Bobbi Brown foundation stick COL ltable.Color VAL Almond 	  COL rtable.ID VAL AM1422 COL rtable.Color VAL Warm Sand COL rtable.Description VAL Bobbi Brown Foundation Stick Warm Sand # 2.5 Full Size (Box) 	 0
 COL ltable.Product_id VAL 973 COL ltable.Description VAL CLINIQUE chubby stick moisturizing lip colour balm COL ltable.Color VAL Voluptuous Violet 	  COL rtable.ID VAL AM2062 COL rtable.Color VAL Chunky Cherry COL rtable.Description VAL Clinique Chubby Stick Moisturizing Lip Colour Balm, #05 Chunky Cherry 	 0
 COL ltable.Product_id VAL 823 COL ltable.Description VAL Smashbox 24 hour cc spot concealer COL ltable.Color VAL Light 	  COL rtable.ID VAL AM1928 COL rtable.Color VAL Fair Light COL rtable.Description VAL Smashbox 24 Hour CC Spot Concealer .008 fl. oz. - Fair/Light 	 0
 COL ltable.Product_id VAL 9973 COL ltable.Description VAL Smashbox try it kit COL ltable.Color VAL nan 	  COL rtable.ID VAL AM4002 COL rtable.Color VAL Fair COL rtable.Description VAL Smashbox Try It Kit BB + Halo - Fair 	 0
 COL ltable.Product_id VAL 858 COL ltable.Description VAL bareMinerals bareminerals ready touch up veil broad spectrum spf 15 COL ltable.Color VAL Tan 	  COL rtable.ID VAL AM5046 COL rtable.Color VAL Tan  COL rtable.Description VAL BareEscentual bareMinerals READY Touch Up Veil Broad Spectrum Spf 15 Tan 10 Grms/0.3 Oz 	 1
 COL ltable.Product_id VAL 9928 COL ltable.Description VAL COVER FX blotting powder COL ltable.Color VAL Light 	  COL rtable.ID VAL AM0943 COL rtable.Color VAL Medium COL rtable.Description VAL COVER FX Matte Oil Absorbing Primer & Blotting Powder - Medium 	 0
 COL ltable.Product_id VAL 1644 COL ltable.Description VAL Bobbi Brown long wear even finish foundation spf 15 COL ltable.Color VAL Cool Beige 	  COL rtable.ID VAL AM3946 COL rtable.Color VAL Warm Walnut COL rtable.Description VAL Bobbi Brown Long Wear Even Finish Foundation SPF 15 - # 7.5 Warm Walnut 30ml/1oz 	 0
 COL ltable.Product_id VAL 659 COL ltable.Description VAL Giorgio Armani luminous silk foundation COL ltable.Color VAL 11.5 	  COL rtable.ID VAL AM1369 COL rtable.Color VAL 4.75 COL rtable.Description VAL Giorgio Armani Luminous Silk Foundation 1oz - # 4.75, (BNIB) 	 0
 COL ltable.Product_id VAL 1564 COL ltable.Description VAL Guerlain kisskiss roselip COL ltable.Color VAL Pink Me Up R373 	  COL rtable.ID VAL AM3699 COL rtable.Color VAL Pink Me Up COL rtable.Description VAL Guerlain KissKiss Roselip Lip Balm - Pink Me Up R373 	 1
 COL ltable.Product_id VAL 2245 COL ltable.Description VAL CLINIQUE brow shaper COL ltable.Color VAL Charcoaled  	  COL rtable.ID VAL AM5020 COL rtable.Color VAL Charcoaled  COL rtable.Description VAL Clinique Brow Shaper Charcoaled 	 1
 COL ltable.Product_id VAL 9863 COL ltable.Description VAL Bobbi Brown foundation stick COL ltable.Color VAL Warm Ivory 	  COL rtable.ID VAL AM5089 COL rtable.Color VAL Warm Ivory COL rtable.Description VAL Exclusive Make Up Product By Bobbi Brown Foundation Stick - #1 Warm Ivory 9g/0.31oz 	 1
 COL ltable.Product_id VAL 3166 COL ltable.Description VAL Bobbi Brown lip gloss COL ltable.Color VAL Nude 	  COL rtable.ID VAL AM5094 COL rtable.Color VAL Nude COL rtable.Description VAL Bobbi Brown Lip Gloss (New Packaging) - # 8 Nude - 7ml/0.24oz 	 1
 COL ltable.Product_id VAL 297 COL ltable.Description VAL Marc Jacobs Beauty new nudes sheer lip gel COL ltable.Color VAL Eat Cake 150 	  COL rtable.ID VAL AM0535 COL rtable.Color VAL Eat Cake 150 COL rtable.Description VAL Marc Jacobs Beauty New Nudes Sheer Lip Gel Eat Cake - Rosy Nude 	 1
 COL ltable.Product_id VAL 9387 COL ltable.Description VAL Bobbi Brown bronzing powder COL ltable.Color VAL Deep 	  COL rtable.ID VAL AM5163 COL rtable.Color VAL Pink Peony COL rtable.Description VAL BOBBI BROWN Pink Peony Set :Pink Peony Illuminating Bronzing Powder +Mini Face Blender Brush . 	 0
 COL ltable.Product_id VAL 4755 COL ltable.Description VAL Ecobrow defining wax COL ltable.Color VAL Rita 	  COL rtable.ID VAL AM3681 COL rtable.Color VAL Penelope COL rtable.Description VAL EcoBrow - All Natural Eyebrow Defining Wax (Penelope) 	 0
 COL ltable.Product_id VAL 531 COL ltable.Description VAL Dior airflash matte touch COL ltable.Color VAL nan 	  COL rtable.ID VAL AM0951 COL rtable.Color VAL nan COL rtable.Description VAL Dior Airflash Matte Touch 	 1
 COL ltable.Product_id VAL 4782 COL ltable.Description VAL Estee Lauder pure color envy sculpting lipstick COL ltable.Color VAL Tumultuous Pink 	  COL rtable.ID VAL AM0719 COL rtable.Color VAL Suggestive COL rtable.Description VAL Estee Lauder Pure Color Envy Shine Sculpting Shine Lipstick - #220 Suggestive 3.1g/0.1oz 	 0
 COL ltable.Product_id VAL 384 COL ltable.Description VAL Urban Decay naked2 COL ltable.Color VAL nan 	  COL rtable.ID VAL AM0607 COL rtable.Color VAL nan COL rtable.Description VAL Urban Decay Naked2 	 1
 COL ltable.Product_id VAL 661 COL ltable.Description VAL Giorgio Armani luminous silk foundation COL ltable.Color VAL 2 	  COL rtable.ID VAL AM1333 COL rtable.Color VAL 4.75 COL rtable.Description VAL Giorgio Armani Luminous Silk Foundation 1oz - # 4.75, (BNIB) 	 0
 COL ltable.Product_id VAL 9225 COL ltable.Description VAL Hourglass ambient lighting blush COL ltable.Color VAL Diffused Heat 	  COL rtable.ID VAL AM4058 COL rtable.Color VAL nan COL rtable.Description VAL Hourglass Ambient Lighting Blush Palette 2014 	 0
 COL ltable.Product_id VAL 422 COL ltable.Description VAL Too Faced melted liquified long wear lipstick COL ltable.Color VAL Melted Candy 	  COL rtable.ID VAL AM0724 COL rtable.Color VAL Melted Candy COL rtable.Description VAL Too Faced Melted Liquified Long Wear Lipstick - Melted Candy 0.16 Fl oz 	 1
 COL ltable.Product_id VAL 9387 COL ltable.Description VAL Bobbi Brown bronzing powder COL ltable.Color VAL Deep 	  COL rtable.ID VAL AM4360 COL rtable.Color VAL Tawny Brown COL rtable.Description VAL Bobbi Brown Bronzing Powder - Tawny Brown 0.28 Oz, (BNIB) 	 0
 COL ltable.Product_id VAL 9402 COL ltable.Description VAL Laura Mercier eye colour COL ltable.Color VAL African Violet 	  COL rtable.ID VAL AM4110 COL rtable.Color VAL nan COL rtable.Description VAL Laura Mercier Artists Palette For Eyes & Cheeks (8x Eye Colour, 1x Highlighter) - 	 0
 COL ltable.Product_id VAL 4976 COL ltable.Description VAL Laura Mercier secret camouflage COL ltable.Color VAL SC-5 	  COL rtable.ID VAL AM5405 COL rtable.Color VAL SC-1 COL rtable.Description VAL Laura Mercier Secret Camouflage - # SC1 (For Very Fair Skin Tones) - 5.92g/0.207oz 	 0
 COL ltable.Product_id VAL 9857 COL ltable.Description VAL Bobbi Brown foundation stick COL ltable.Color VAL Porcelain 	  COL rtable.ID VAL AM5089 COL rtable.Color VAL Warm Ivory COL rtable.Description VAL Exclusive Make Up Product By Bobbi Brown Foundation Stick - #1 Warm Ivory 9g/0.31oz 	 0
 COL ltable.Product_id VAL 6958 COL ltable.Description VAL Dior diorshow waterproof mascara COL ltable.Color VAL Catwalk Black 	  COL rtable.ID VAL AM1150 COL rtable.Color VAL 099 Kohl COL rtable.Description VAL Dior DiorShow Black Out Waterproof Intense Black-Kohl Mascara 099 Khol 	 0
 COL ltable.Product_id VAL 2537 COL ltable.Description VAL MAKE UP FOR EVER aqua eyes COL ltable.Color VAL Dark Grey 21L 	  COL rtable.ID VAL AM6043 COL rtable.Color VAL Turquoise COL rtable.Description VAL MAKE UP FOR EVER Aqua Eyes Turquoise 7L 	 0
 COL ltable.Product_id VAL 2549 COL ltable.Description VAL MAKE UP FOR EVER aqua eyes COL ltable.Color VAL Pearly Brown 2L 	  COL rtable.ID VAL AM6017 COL rtable.Color VAL Pearly Brown 2L COL rtable.Description VAL MAKE UP FOR EVER Aqua Eyes Pearly Brown 2L 0.04 oz 	 1
 COL ltable.Product_id VAL 3794 COL ltable.Description VAL Laura Mercier mineral powder spf 15 COL ltable.Color VAL Classic Beige 	  COL rtable.ID VAL AM1131 COL rtable.Color VAL Tender Rose COL rtable.Description VAL Laura Mercier Mineral Pressed Powder SPF 15 Tender Rose 	 0
 COL ltable.Product_id VAL 9229 COL ltable.Description VAL Hourglass ambient lighting blush COL ltable.Color VAL Luminous Flush 	  COL rtable.ID VAL AM4058 COL rtable.Color VAL nan COL rtable.Description VAL Hourglass Ambient Lighting Blush Palette 2014 	 0
 COL ltable.Product_id VAL 1570 COL ltable.Description VAL MAKE UP FOR EVER pro finish multi use powder foundation COL ltable.Color VAL 118 Neutral Beige 	  COL rtable.ID VAL AM3741 COL rtable.Color VAL Neutral Saffron COL rtable.Description VAL Make Up For Ever Pro Finish Multi Use Powder Foundation - # 174 Neutral Saffron 10g/0.35oz 	 0
 COL ltable.Product_id VAL 802 COL ltable.Description VAL Guerlain terracotta bronzing powder COL ltable.Color VAL 1 	  COL rtable.ID VAL AM1774 COL rtable.Color VAL 1 COL rtable.Description VAL Guerlain Terracotta Bronzing Powder, Moisturizing and Long Lasting, # 01, 0.35 Ounce 	 1
 COL ltable.Product_id VAL 8926 COL ltable.Description VAL Smashbox full exposure mascara COL ltable.Color VAL Jet Black 	  COL rtable.ID VAL AM4447 COL rtable.Color VAL nan COL rtable.Description VAL SMASHBOX On The Rocks MINI BEST SELLERS KIT Photo-Finish Foundation Primer, Hydrating Under Eye Primer, & Full Exposure Mascara 	 0
 COL ltable.Product_id VAL 9927 COL ltable.Description VAL COVER FX blotting powder COL ltable.Color VAL Deep 	  COL rtable.ID VAL AM0943 COL rtable.Color VAL Medium COL rtable.Description VAL COVER FX Matte Oil Absorbing Primer & Blotting Powder - Medium 	 0
 COL ltable.Product_id VAL 421 COL ltable.Description VAL Too Faced melted liquified long wear lipstick COL ltable.Color VAL Melted Berry 	  COL rtable.ID VAL AM0778 COL rtable.Color VAL Melted Velvet COL rtable.Description VAL Too Faced - Melted Liquified Long Wear Lipstick - Melted Velvet 	 0
 COL ltable.Product_id VAL 2538 COL ltable.Description VAL MAKE UP FOR EVER aqua eyes COL ltable.Color VAL Forest Green 20L 	  COL rtable.ID VAL AM5983 COL rtable.Color VAL Purple 6L COL rtable.Description VAL MAKE UP FOR EVER Aqua Eyes Black Purple 6L 	 0
 COL ltable.Product_id VAL 3794 COL ltable.Description VAL Laura Mercier mineral powder spf 15 COL ltable.Color VAL Classic Beige 	  COL rtable.ID VAL AM1132 COL rtable.Color VAL Tender Rose COL rtable.Description VAL Laura Mercier Mineral Pressed Powder SPF 15 Tender Rose 0.28 oz./8.1g 	 0
 COL ltable.Product_id VAL 1561 COL ltable.Description VAL Guerlain kisskiss roselip COL ltable.Color VAL Crazy Bouquet R329 	  COL rtable.ID VAL AM3697 COL rtable.Color VAL Crazy Bouquet COL rtable.Description VAL Guerlain KissKiss Roselip Lip Balm - Crazy Bouquet R329 	 1
 COL ltable.Product_id VAL 6459 COL ltable.Description VAL NARS brow gel COL ltable.Color VAL Piraeus 	  COL rtable.ID VAL AM1629 COL rtable.Color VAL Kinshasa COL rtable.Description VAL NARS Brow Gel, Kinshasa 	 0
 COL ltable.Product_id VAL 1644 COL ltable.Description VAL Bobbi Brown long wear even finish foundation spf 15 COL ltable.Color VAL Cool Beige 	  COL rtable.ID VAL AM3945 COL rtable.Color VAL Warm Walnut COL rtable.Description VAL Bobbi Brown Long Wear Even Finish Foundation SPF 15 - # 7.5 Warm Walnut - 30ml/1oz 	 0
 COL ltable.Product_id VAL 9843 COL ltable.Description VAL Bobbi Brown foundation stick COL ltable.Color VAL Alabaster 	  COL rtable.ID VAL AM5089 COL rtable.Color VAL Warm Ivory COL rtable.Description VAL Exclusive Make Up Product By Bobbi Brown Foundation Stick - #1 Warm Ivory 9g/0.31oz 	 0
 COL ltable.Product_id VAL 53 COL ltable.Description VAL Dior star concealer COL ltable.Color VAL 002 Beige 	  COL rtable.ID VAL AM0074 COL rtable.Color VAL Beige 002 COL rtable.Description VAL Dior DiorSkin Star Concealer Beige 002 	 1
 COL ltable.Product_id VAL 1608 COL ltable.Description VAL NARS all day luminous weightless foundation COL ltable.Color VAL Deauville 	  COL rtable.ID VAL AM3789 COL rtable.Color VAL Punjab COL rtable.Description VAL NARS All Day Luminous Weightless Foundation Shade Punjab Medium 1 - Medium with golden, peachy undertones 30ml 	 0
 COL ltable.Product_id VAL 489 COL ltable.Description VAL MAKE UP FOR EVER full cover concealer COL ltable.Color VAL Sand 7 	  COL rtable.ID VAL AM0878 COL rtable.Color VAL Sand 7 COL rtable.Description VAL MAKE UP FOR EVER Full Cover Concealer Sand 7 0.5 oz 	 1
 COL ltable.Product_id VAL 9227 COL ltable.Description VAL Hourglass ambient lighting blush COL ltable.Color VAL Ethereal Glow 	  COL rtable.ID VAL AM4058 COL rtable.Color VAL nan COL rtable.Description VAL Hourglass Ambient Lighting Blush Palette 2014 	 0
 COL ltable.Product_id VAL 374 COL ltable.Description VAL Urban Decay naked palette COL ltable.Color VAL nan 	  COL rtable.ID VAL AM0525 COL rtable.Color VAL nan COL rtable.Description VAL Urban Decay Naked Palette 	 1
 COL ltable.Product_id VAL 10695 COL ltable.Description VAL CLINIQUE high impact mascara COL ltable.Color VAL Black  	  COL rtable.ID VAL AM1582 COL rtable.Color VAL Purple COL rtable.Description VAL Clinique Eye Makeup Expert (1x Quickliner, 1x Chubby Stick Shadow, 1x High Impact Mascara) - Purple - 3pcs 	 0
 COL ltable.Product_id VAL 3727 COL ltable.Description VAL Dior diorshow mascara COL ltable.Color VAL Blue 258 	  COL rtable.ID VAL AM1149 COL rtable.Color VAL 099 Kohl Black COL rtable.Description VAL Dior Diorshow Black Out Mascara Size 0.33 Oz Color Kohl Black 099 - Rich Black 	 0
 COL ltable.Product_id VAL 2247 COL ltable.Description VAL CLINIQUE brow shaper COL ltable.Color VAL Soft Brown  	  COL rtable.ID VAL AM5020 COL rtable.Color VAL Charcoaled COL rtable.Description VAL Clinique Brow Shaper Charcoaled 	 0
 COL ltable.Product_id VAL 2366 COL ltable.Description VAL Laura Mercier secret concealer COL ltable.Color VAL 2.5 	  COL rtable.ID VAL AM5308 COL rtable.Color VAL 2.5 COL rtable.Description VAL Laura Mercier Secret Concealer - #2.5 2.2g/0.08oz 	 1
 COL ltable.Product_id VAL 4975 COL ltable.Description VAL Laura Mercier secret camouflage COL ltable.Color VAL SC-4 	  COL rtable.ID VAL AM5314 COL rtable.Color VAL SC-2 COL rtable.Description VAL Laura Mercier Secret Camouflage - # SC2 (For Fair to Light Skin Tones) - 5.92g/0.207oz 	 0
 COL ltable.Product_id VAL 1571 COL ltable.Description VAL MAKE UP FOR EVER pro finish multi use powder foundation COL ltable.Color VAL 120 Neutral Ivory 	  COL rtable.ID VAL AM3715 COL rtable.Color VAL Neutral Beige COL rtable.Description VAL Make Up For Ever Pro Finish Multi Use Powder Foundation - # 118 Neutral Beige 10g/0.35oz 	 0
 COL ltable.Product_id VAL 2440 COL ltable.Description VAL CLINIQUE line smoothing concealer COL ltable.Color VAL Deep Honey  	  COL rtable.ID VAL AM5635 COL rtable.Color VAL Deep Honey COL rtable.Description VAL Clinique Line Smoothing Concealer 10 Deep Honey 	 1
 COL ltable.Product_id VAL 4973 COL ltable.Description VAL Laura Mercier secret camouflage COL ltable.Color VAL SC-2 	  COL rtable.ID VAL AM5425 COL rtable.Color VAL SC-2 COL rtable.Description VAL Laura Mercier Secret Camouflage - # SC3 (Medium with Yellow or Pink Skin Tones) 5.92g/0.207oz 	 1
 COL ltable.Product_id VAL 728 COL ltable.Description VAL CLINIQUE chubby stick shadow tint for eyes COL ltable.Color VAL Curvaceous Coal 	  COL rtable.ID VAL AM6342 COL rtable.Color VAL Fuller Fudge COL rtable.Description VAL Clinique - Chubby Stick Shadow Tint For Eyes - # 03 Fuller Fudge (0.1 oz.) 1 pcs sku# 1900580MA 	 0
 COL ltable.Product_id VAL 9404 COL ltable.Description VAL Laura Mercier eye colour COL ltable.Color VAL Cashmere 	  COL rtable.ID VAL AM4110 COL rtable.Color VAL nan COL rtable.Description VAL Laura Mercier Artists Palette For Eyes & Cheeks (8x Eye Colour, 1x Highlighter) - 	 0
 COL ltable.Product_id VAL 2491 COL ltable.Description VAL Bobbi Brown corrector COL ltable.Color VAL Dark Peach 	  COL rtable.ID VAL AM5759 COL rtable.Color VAL Bisque COL rtable.Description VAL BOBBI BROWN Corrector - Bisque 	 0
 COL ltable.Product_id VAL 10045 COL ltable.Description VAL Black Up foundation brush COL ltable.Color VAL nan 	  COL rtable.ID VAL AM4222 COL rtable.Color VAL nan COL rtable.Description VAL Beety Luxurious Synthetic Make Up Brush Set Cosmetics Foundation Blending Blush Eyeliner Face Powder Brush Makeup Brush Kit (10pcs, Silver Black) 	 0
 COL ltable.Product_id VAL 9390 COL ltable.Description VAL Bobbi Brown bronzing powder COL ltable.Color VAL Natural 	  COL rtable.ID VAL AM4360 COL rtable.Color VAL Tawny Brown COL rtable.Description VAL Bobbi Brown Bronzing Powder - Tawny Brown 0.28 Oz, (BNIB) 	 0
 COL ltable.Product_id VAL 9048 COL ltable.Description VAL stila illuminating powder foundation COL ltable.Color VAL 80 Watts 	  COL rtable.ID VAL AM1645 COL rtable.Color VAL nan COL rtable.Description VAL stila Illuminating Powder Foundation Refillable Compact 	 0
 COL ltable.Product_id VAL 4640 COL ltable.Description VAL Estee Lauder double wear stay in place makeup COL ltable.Color VAL Ecru 1N2 	  COL rtable.ID VAL AM5002 COL rtable.Color VAL 13 COL rtable.Description VAL Estee Lauder Double Wear Light Stay In Place Makeup SPF 10 1 oz # 13 Intensity 4.0 	 0
 COL ltable.Product_id VAL 2493 COL ltable.Description VAL Bobbi Brown corrector COL ltable.Color VAL Light Bisque 	  COL rtable.ID VAL AM5757 COL rtable.Color VAL Light to Medium Bisque COL rtable.Description VAL Bobbi Brown Light to Medium Bisque Corrector .05 oz 	 0
 COL ltable.Product_id VAL 1231 COL ltable.Description VAL Hourglass modernist eyeshadow palette COL ltable.Color VAL Monochrome (Rose) 	  COL rtable.ID VAL AM2608 COL rtable.Color VAL Obscura (Earth Tones) COL rtable.Description VAL Hourglass Modernist Eyeshadow Palette - Obscura (Earth Tones) 	 0
 COL ltable.Product_id VAL 8406 COL ltable.Description VAL Bobbi Brown eye shadow COL ltable.Color VAL Toast 	  COL rtable.ID VAL AM1673 COL rtable.Color VAL Nude COL rtable.Description VAL Bobbi Brown Nude Glow Limited Edition Eye Shadow Quad Palette - Nude 	 0
 COL ltable.Product_id VAL 2495 COL ltable.Description VAL Bobbi Brown corrector COL ltable.Color VAL Light to Medium Bisque 	  COL rtable.ID VAL AM5757 COL rtable.Color VAL Light to Medium Bisque COL rtable.Description VAL Bobbi Brown Light to Medium Bisque Corrector .05 oz 	 1
 COL ltable.Product_id VAL 9044 COL ltable.Description VAL stila illuminating powder foundation COL ltable.Color VAL 40 Watts 	  COL rtable.ID VAL AM1645 COL rtable.Color VAL nan COL rtable.Description VAL stila Illuminating Powder Foundation Refillable Compact 	 0
 COL ltable.Product_id VAL 821 COL ltable.Description VAL Smashbox 24 hour cc spot concealer COL ltable.Color VAL Fair 	  COL rtable.ID VAL AM1927 COL rtable.Color VAL Fair COL rtable.Description VAL Smashbox 24 Hour CC Spot Concealer - Fair 0.08oz 	 1
 COL ltable.Product_id VAL 2495 COL ltable.Description VAL Bobbi Brown corrector COL ltable.Color VAL Light to Medium Bisque 	  COL rtable.ID VAL AM5759 COL rtable.Color VAL Bisque COL rtable.Description VAL BOBBI BROWN Corrector - Bisque 	 0
 COL ltable.Product_id VAL 1499 COL ltable.Description VAL CLINIQUE even better makeup spf 15 COL ltable.Color VAL Ginger 	  COL rtable.ID VAL AM3583 COL rtable.Color VAL Ivory COL rtable.Description VAL New 2013 Clinique Even Better Compact Makeup Spf 15 ~ IVORY 	 0
 COL ltable.Product_id VAL 1231 COL ltable.Description VAL Hourglass modernist eyeshadow palette COL ltable.Color VAL Monochrome (Rose) 	  COL rtable.ID VAL AM2605 COL rtable.Color VAL Monochrome (Rose) COL rtable.Description VAL Hourglass Modernist Eyeshadow Palette - Monochrome (Rose) 	 1
 COL ltable.Product_id VAL 801 COL ltable.Description VAL Guerlain terracotta bronzing powder COL ltable.Color VAL 0 	  COL rtable.ID VAL AM1775 COL rtable.Color VAL 1 COL rtable.Description VAL Terracotta Bronzing Powder ( Moisturising & Long Lasting ) - No. 01 - Guerlain - Powder - Terracotta Bronzing Powder ( Moisturising & Long Lasting ) - 10g/0.35oz 	 0
 COL ltable.Product_id VAL 802 COL ltable.Description VAL Guerlain terracotta bronzing powder COL ltable.Color VAL 1 	  COL rtable.ID VAL AM1775 COL rtable.Color VAL 1 COL rtable.Description VAL Terracotta Bronzing Powder ( Moisturising & Long Lasting ) - No. 01 - Guerlain - Powder - Terracotta Bronzing Powder ( Moisturising & Long Lasting ) - 10g/0.35oz 	 1
 COL ltable.Product_id VAL 9045 COL ltable.Description VAL stila illuminating powder foundation COL ltable.Color VAL 50 Watts 	  COL rtable.ID VAL AM1645 COL rtable.Color VAL nan COL rtable.Description VAL stila Illuminating Powder Foundation Refillable Compact 	 0
 COL ltable.Product_id VAL 7991 COL ltable.Description VAL NARS blush bronzer duo COL ltable.Color VAL Orgasm/ Laguna 	  COL rtable.ID VAL AM4681 COL rtable.Color VAL Orgasm / Laguna COL rtable.Description VAL NARS Bronzer Blush Duo, Orgasm/Laguna 	 1
 COL ltable.Product_id VAL 2168 COL ltable.Description VAL Laura Mercier creme smooth lip colour COL ltable.Color VAL Mango 	  COL rtable.ID VAL AM4840 COL rtable.Color VAL Mango COL rtable.Description VAL Laura Mercier Creme Smooth Lip Colour # Mango 4G/0.14Oz 	 1
 COL ltable.Product_id VAL 9863 COL ltable.Description VAL Bobbi Brown foundation stick COL ltable.Color VAL Warm Ivory 	  COL rtable.ID VAL AM1422 COL rtable.Color VAL Warm Sand COL rtable.Description VAL Bobbi Brown Foundation Stick Warm Sand # 2.5 Full Size (Box) 	 0
 COL ltable.Product_id VAL 1112 COL ltable.Description VAL NARS kudoki kabuki brush COL ltable.Color VAL nan 	  COL rtable.ID VAL AM2342 COL rtable.Color VAL nan COL rtable.Description VAL NARS Kudoki Kabuki Brush - 	 1
 COL ltable.Product_id VAL 1658 COL ltable.Description VAL Bobbi Brown long wear even finish foundation spf 15 COL ltable.Color VAL Warm Sand 	  COL rtable.ID VAL AM3946 COL rtable.Color VAL Warm Walnut COL rtable.Description VAL Bobbi Brown Long Wear Even Finish Foundation SPF 15 - # 7.5 Warm Walnut 30ml/1oz 	 0
 COL ltable.Product_id VAL 9860 COL ltable.Description VAL Bobbi Brown foundation stick COL ltable.Color VAL Warm Almond 	  COL rtable.ID VAL AM5089 COL rtable.Color VAL Warm Ivory COL rtable.Description VAL Exclusive Make Up Product By Bobbi Brown Foundation Stick - #1 Warm Ivory 9g/0.31oz 	 0
 COL ltable.Product_id VAL 2587 COL ltable.Description VAL CLINIQUE superfine liner for brows COL ltable.Color VAL Deep Brown  	  COL rtable.ID VAL AM6104 COL rtable.Color VAL Deep Brown  COL rtable.Description VAL Clinique Superfine Liner for Brows 03 Deep Brown 	 1
 COL ltable.Product_id VAL 490 COL ltable.Description VAL MAKE UP FOR EVER full cover concealer COL ltable.Color VAL Vanilla 5 	  COL rtable.ID VAL AM0865 COL rtable.Color VAL Beige 8 COL rtable.Description VAL MAKE UP FOR EVER Full Cover Concealer Beige 8 	 0
 COL ltable.Product_id VAL 1130 COL ltable.Description VAL Dior diorskin nude skin perfecting hydrating concealer COL ltable.Color VAL Beige 002 	  COL rtable.ID VAL AM2379 COL rtable.Color VAL Beige 002 COL rtable.Description VAL Christian Dior Diorskin Nude Skin Perfecting Hydrating Concealer - # 002 Beige 10ml/0.33oz 	 1
 COL ltable.Product_id VAL 8407 COL ltable.Description VAL Bobbi Brown eye shadow COL ltable.Color VAL White 	  COL rtable.ID VAL AM1673 COL rtable.Color VAL Nude COL rtable.Description VAL Bobbi Brown Nude Glow Limited Edition Eye Shadow Quad Palette - Nude 	 0
 COL ltable.Product_id VAL 9047 COL ltable.Description VAL stila illuminating powder foundation COL ltable.Color VAL 70 Watts 	  COL rtable.ID VAL AM1645 COL rtable.Color VAL nan COL rtable.Description VAL stila Illuminating Powder Foundation Refillable Compact 	 0
 COL ltable.Product_id VAL 9856 COL ltable.Description VAL Bobbi Brown foundation stick COL ltable.Color VAL Natural Tan 	  COL rtable.ID VAL AM1422 COL rtable.Color VAL Warm Sand COL rtable.Description VAL Bobbi Brown Foundation Stick Warm Sand # 2.5 Full Size (Box) 	 0
 COL ltable.Product_id VAL 2490 COL ltable.Description VAL Bobbi Brown corrector COL ltable.Color VAL Dark Bisque 	  COL rtable.ID VAL AM5757 COL rtable.Color VAL Light to Medium Bisque COL rtable.Description VAL Bobbi Brown Light to Medium Bisque Corrector .05 oz 	 0
 COL ltable.Product_id VAL 729 COL ltable.Description VAL CLINIQUE chubby stick shadow tint for eyes COL ltable.Color VAL Fuller Fudge 	  COL rtable.ID VAL AM1551 COL rtable.Color VAL Big Blue COL rtable.Description VAL Clinique Chubby Stick Shadow Tint for Eyes Big Blue 0.1 oz 	 0
 COL ltable.Product_id VAL 511 COL ltable.Description VAL Dior diorskin forever compact flawless perfection fusion wear makeup spf 25 COL ltable.Color VAL Ivory 010 	  COL rtable.ID VAL AM0938 COL rtable.Color VAL Medium Beige 030 COL rtable.Description VAL Exclusive By Christian Dior Diorskin Forever Compact Flawless Perfection Fusion Wear Makeup SPF 25 - #030 Medium Beige 10g/0.35oz 	 0
 COL ltable.Product_id VAL 1613 COL ltable.Description VAL NARS all day luminous weightless foundation COL ltable.Color VAL Mont Blanc 	  COL rtable.ID VAL AM3783 COL rtable.Color VAL Mont Blanc COL rtable.Description VAL NARS All Day Luminous Weightless Foundation, shade=Mont Blanc 	 1
 COL ltable.Product_id VAL 2171 COL ltable.Description VAL Laura Mercier creme smooth lip colour COL ltable.Color VAL Palm Beach 	  COL rtable.ID VAL AM4832 COL rtable.Color VAL Palm Beach COL rtable.Description VAL Laura Mercier Creme Smooth Lip Colour # Palm Beach 4G/0.14Oz 	 1
 COL ltable.Product_id VAL 1805 COL ltable.Description VAL Buxom big sexy bold gel lipstick COL ltable.Color VAL Coral Confession 	  COL rtable.ID VAL AM4172 COL rtable.Color VAL Coral Confession COL rtable.Description VAL Buxom Big & Sexy Bold Gel Lipstick (Coral Confession) 	 1
 COL ltable.Product_id VAL 1627 COL ltable.Description VAL Hourglass extreme sheen high shine lip gloss COL ltable.Color VAL Child 	  COL rtable.ID VAL AM3834 COL rtable.Color VAL Verse COL rtable.Description VAL Hourglass Extreme Sheen High Shine Lip Gloss Verse 	 0
 COL ltable.Product_id VAL 9863 COL ltable.Description VAL Bobbi Brown foundation stick COL ltable.Color VAL Warm Ivory 	  COL rtable.ID VAL AM5089 COL rtable.Color VAL Warm Ivory COL rtable.Description VAL Exclusive Make Up Product By Bobbi Brown Foundation Stick - #1 Warm Ivory 9g/0.31oz 	 1
 COL ltable.Product_id VAL 739 COL ltable.Description VAL CLINIQUE chubby stick shadow tint for eyes COL ltable.Color VAL Two Ton Teal 	  COL rtable.ID VAL AM6343 COL rtable.Color VAL Ample Amber COL rtable.Description VAL Clinique Chubby Stick Ample Amber Shadow Tint for Eyes Ample Amber 04 Full Size New in Box 	 0
 COL ltable.Product_id VAL 1302 COL ltable.Description VAL bareMinerals secret weapon trade correcting concealer touch up veil duo COL ltable.Color VAL Light 1 	  COL rtable.ID VAL AM0236 COL rtable.Color VAL Light 1 COL rtable.Description VAL BareMinerals Secret Weapon Correcting Concealer and Touch Up Veil Duo Light 1 	 1
 COL ltable.Product_id VAL 9864 COL ltable.Description VAL Bobbi Brown foundation stick COL ltable.Color VAL Warm Natural 	  COL rtable.ID VAL AM1422 COL rtable.Color VAL Warm Sand COL rtable.Description VAL Bobbi Brown Foundation Stick Warm Sand # 2.5 Full Size (Box) 	 0
 COL ltable.Product_id VAL 9862 COL ltable.Description VAL Bobbi Brown foundation stick COL ltable.Color VAL Warm Honey 	  COL rtable.ID VAL AM1422 COL rtable.Color VAL Warm Sand COL rtable.Description VAL Bobbi Brown Foundation Stick Warm Sand # 2.5 Full Size (Box) 	 0
 COL ltable.Product_id VAL 8818 COL ltable.Description VAL tarte lipsurgence lip tint COL ltable.Color VAL Enchanted 	  COL rtable.ID VAL AM2776 COL rtable.Color VAL Energy COL rtable.Description VAL Tarte Lipsurgence Skintuitive Lip Tint - Energy (.10 oz) 	 0
 COL ltable.Product_id VAL 804 COL ltable.Description VAL Guerlain terracotta bronzing powder COL ltable.Color VAL 3 	  COL rtable.ID VAL AM1775 COL rtable.Color VAL 1 COL rtable.Description VAL Terracotta Bronzing Powder ( Moisturising & Long Lasting ) - No. 01 - Guerlain - Powder - Terracotta Bronzing Powder ( Moisturising & Long Lasting ) - 10g/0.35oz 	 0
 COL ltable.Product_id VAL 499 COL ltable.Description VAL tarte maracuja lip exfoliant COL ltable.Color VAL nan 	  COL rtable.ID VAL AM0890 COL rtable.Color VAL nan COL rtable.Description VAL Tarte Maracuja Lip Exfoliant 	 1
 COL ltable.Product_id VAL 9855 COL ltable.Description VAL Bobbi Brown foundation stick COL ltable.Color VAL Natural 	  COL rtable.ID VAL AM5089 COL rtable.Color VAL Warm Ivory COL rtable.Description VAL Exclusive Make Up Product By Bobbi Brown Foundation Stick - #1 Warm Ivory 9g/0.31oz 	 0
 COL ltable.Product_id VAL 9864 COL ltable.Description VAL Bobbi Brown foundation stick COL ltable.Color VAL Warm Natural 	  COL rtable.ID VAL AM5089 COL rtable.Color VAL Warm Ivory COL rtable.Description VAL Exclusive Make Up Product By Bobbi Brown Foundation Stick - #1 Warm Ivory 9g/0.31oz 	 0
 COL ltable.Product_id VAL 9863 COL ltable.Description VAL Bobbi Brown foundation stick COL ltable.Color VAL Warm Ivory 	  COL rtable.ID VAL AM1422 COL rtable.Color VAL Warm Sand COL rtable.Description VAL Bobbi Brown Foundation Stick Warm Sand # 2.5 Full Size (Box) 	 0
 COL ltable.Product_id VAL 10556 COL ltable.Description VAL NARS lip gloss COL ltable.Color VAL Chihuahua 	  COL rtable.ID VAL AM1702 COL rtable.Color VAL New Lover COL rtable.Description VAL NARS Velvet Gloss Lip Pencil, New Lover 	 0
 COL ltable.Product_id VAL 9845 COL ltable.Description VAL Bobbi Brown foundation stick COL ltable.Color VAL Beige 	  COL rtable.ID VAL AM5089 COL rtable.Color VAL Warm Ivory COL rtable.Description VAL Exclusive Make Up Product By Bobbi Brown Foundation Stick - #1 Warm Ivory 9g/0.31oz 	 0
 COL ltable.Product_id VAL 512 COL ltable.Description VAL Dior diorskin forever compact flawless perfection fusion wear makeup spf 25 COL ltable.Color VAL Light Beige 020 	  COL rtable.ID VAL AM0895 COL rtable.Color VAL Dark Beige 050 COL rtable.Description VAL Christian Dior Skin Forever Flawless Perfection SPF 25 Fusion Wear Foundation Makeup, No. 050 Dark Beige, 1 Ounce 	 0
 COL ltable.Product_id VAL 933 COL ltable.Description VAL tarte amazonian clay volumizing brow powder COL ltable.Color VAL Rich Brown 	  COL rtable.ID VAL AM2053 COL rtable.Color VAL Rich Brown COL rtable.Description VAL Tarte Amazonian Clay Volumizing Brow & Hair Powder - Rich Brown 	 1
 COL ltable.Product_id VAL 822 COL ltable.Description VAL Smashbox 24 hour cc spot concealer COL ltable.Color VAL Fair Light 	  COL rtable.ID VAL AM1948 COL rtable.Color VAL Medium Light COL rtable.Description VAL Smashbox 24 Hour CC Spot Concealer - Medium/Light 0.08oz 	 0
 COL ltable.Product_id VAL 4975 COL ltable.Description VAL Laura Mercier secret camouflage COL ltable.Color VAL SC-4 	  COL rtable.ID VAL AM0736 COL rtable.Color VAL camouflage brush,camouflage brush,camouflage brush COL rtable.Description VAL Laura Mercier Secret Camouflage Brush, Size Long 	 0
 COL ltable.Product_id VAL 1494 COL ltable.Description VAL CLINIQUE even better makeup spf 15 COL ltable.Color VAL Cream Chamois 	  COL rtable.ID VAL AM2297 COL rtable.Color VAL Amber COL rtable.Description VAL Clinique Even Better Compact Makeup Broad Spectrum SPF 15 21 Cream Caramel 0.35 oz 	 0
 COL ltable.Product_id VAL 9859 COL ltable.Description VAL Bobbi Brown foundation stick COL ltable.Color VAL Walnut 	  COL rtable.ID VAL AM1422 COL rtable.Color VAL Warm Sand COL rtable.Description VAL Bobbi Brown Foundation Stick Warm Sand # 2.5 Full Size (Box) 	 0
 COL ltable.Product_id VAL 1628 COL ltable.Description VAL Hourglass extreme sheen high shine lip gloss COL ltable.Color VAL Fortune 	  COL rtable.ID VAL AM3814 COL rtable.Color VAL Child COL rtable.Description VAL Hourglass Extreme Sheen High Shine Lip Gloss Child 	 0
 COL ltable.Product_id VAL 9865 COL ltable.Description VAL Bobbi Brown foundation stick COL ltable.Color VAL Warm Sand 	  COL rtable.ID VAL AM5089 COL rtable.Color VAL Warm Ivory COL rtable.Description VAL Exclusive Make Up Product By Bobbi Brown Foundation Stick - #1 Warm Ivory 9g/0.31oz 	 0
 COL ltable.Product_id VAL 1303 COL ltable.Description VAL bareMinerals secret weapon trade correcting concealer touch up veil duo COL ltable.Color VAL Light 2 	  COL rtable.ID VAL AM5011 COL rtable.Color VAL Light 2 COL rtable.Description VAL BareMinerals Secret Weapon Correcting Concealer and Touch Up Veil Duo Light 2 	 1
 COL ltable.Product_id VAL 823 COL ltable.Description VAL Smashbox 24 hour cc spot concealer COL ltable.Color VAL Light 	  COL rtable.ID VAL AM1927 COL rtable.Color VAL Fair COL rtable.Description VAL Smashbox 24 Hour CC Spot Concealer - Fair 0.08oz 	 0
 COL ltable.Product_id VAL 9390 COL ltable.Description VAL Bobbi Brown bronzing powder COL ltable.Color VAL Natural 	  COL rtable.ID VAL AM5163 COL rtable.Color VAL Pink Peony COL rtable.Description VAL BOBBI BROWN Pink Peony Set :Pink Peony Illuminating Bronzing Powder +Mini Face Blender Brush . 	 0
 COL ltable.Product_id VAL 1616 COL ltable.Description VAL NARS all day luminous weightless foundation COL ltable.Color VAL Punjab 	  COL rtable.ID VAL AM3791 COL rtable.Color VAL Punjab COL rtable.Description VAL NARS All Day Luminous Weightless Foundation (PUNJAB) 	 1
 COL ltable.Product_id VAL 8821 COL ltable.Description VAL tarte lipsurgence lip tint COL ltable.Color VAL Lovely 	  COL rtable.ID VAL AM2778 COL rtable.Color VAL Energy COL rtable.Description VAL Tarte ENERGY LipSurgence Skintuitive Lip Tint (Mini) 	 0
 COL ltable.Product_id VAL 9231 COL ltable.Description VAL Hourglass ambient lighting blush COL ltable.Color VAL Radiant Magenta 	  COL rtable.ID VAL AM4058 COL rtable.Color VAL nan COL rtable.Description VAL Hourglass Ambient Lighting Blush Palette 2014 	 0
 COL ltable.Product_id VAL 2538 COL ltable.Description VAL MAKE UP FOR EVER aqua eyes COL ltable.Color VAL Forest Green 20L 	  COL rtable.ID VAL AM5984 COL rtable.Color VAL Green 12L COL rtable.Description VAL MAKE UP FOR EVER Aqua Eyes Blue With Green Highlights 12L 0.04 oz 	 0
 COL ltable.Product_id VAL 2537 COL ltable.Description VAL MAKE UP FOR EVER aqua eyes COL ltable.Color VAL Dark Grey 21L 	  COL rtable.ID VAL AM6044 COL rtable.Color VAL Star Black 1L COL rtable.Description VAL Make Up For Ever Aqua Eyes Waterproof Eyeliner Pencil - #1L (Star Black) - 1.2g/0.04oz 	 0
 COL ltable.Product_id VAL 1654 COL ltable.Description VAL Bobbi Brown long wear even finish foundation spf 15 COL ltable.Color VAL Warm Beige 	  COL rtable.ID VAL AM3843 COL rtable.Color VAL Chestnut COL rtable.Description VAL Bobbi Brown Long Wear Even Finish Foundation SPF 15 - # 9 Chestnut 30ml/1oz 	 0
 COL ltable.Product_id VAL 169 COL ltable.Description VAL bareMinerals tapered shadow brush COL ltable.Color VAL nan 	  COL rtable.ID VAL AM0327 COL rtable.Color VAL nan COL rtable.Description VAL BareMinerals Double-ended Tapered Blush and Shadow Brush 	 0
 COL ltable.Product_id VAL 4592 COL ltable.Description VAL Smashbox camera ready bb cream spf 35 COL ltable.Color VAL Light/Medium 	  COL rtable.ID VAL AM4054 COL rtable.Color VAL Light/Medium COL rtable.Description VAL Smashbox Camera Ready BB Cream SPF 35 Light/Medium 	 1
 COL ltable.Product_id VAL 2335 COL ltable.Description VAL Bobbi Brown bb cream broad spectrum spf 35 COL ltable.Color VAL Fair 	  COL rtable.ID VAL AM5190 COL rtable.Color VAL Medium to Dark COL rtable.Description VAL Bobbi Brown BB Cream Broad Spectrum SPF 35 Medium to Dark 1.35 oz 	 0
 COL ltable.Product_id VAL 4974 COL ltable.Description VAL Laura Mercier secret camouflage COL ltable.Color VAL SC-3 	  COL rtable.ID VAL AM5480 COL rtable.Color VAL SC7 COL rtable.Description VAL Secret Camouflage - # SC7 ( For Deep with Honey Skin Tones ) - Laura Mercier - Complexion - Secret Camouflage - 5.92g/0.207oz 	 0
 COL ltable.Product_id VAL 4783 COL ltable.Description VAL Estee Lauder pure color envy sculpting lipstick COL ltable.Color VAL Vengeful Red 	  COL rtable.ID VAL AM0695 COL rtable.Color VAL Baby Cashmere COL rtable.Description VAL EstEEe Lauder Pure Color Envy Shine Sculpting Shine Lipstick 150 Baby Cashmere, 0.1oz, 3.1g by Estee Lauder 	 0
 COL ltable.Product_id VAL 8122 COL ltable.Description VAL Guerlain terracotta light bronzing powder COL ltable.Color VAL Blondes 02 	  COL rtable.ID VAL AM1782 COL rtable.Color VAL Blondes 02 COL rtable.Description VAL Guerlain Terracotta Light Sheer Bronzing Powder No. 02 Blondes (New Packaging) 10G/0.35Oz 	 1
 COL ltable.Product_id VAL 476 COL ltable.Description VAL NARS contour blush COL ltable.Color VAL Gienah 	  COL rtable.ID VAL AM0860 COL rtable.Color VAL Gienah COL rtable.Description VAL Nars Contour Blush Color Gienah Honey Amber 	 1
 COL ltable.Product_id VAL 7967 COL ltable.Description VAL Bobbi Brown powder brush COL ltable.Color VAL nan 	  COL rtable.ID VAL AM5163 COL rtable.Color VAL Pink Peony COL rtable.Description VAL BOBBI BROWN Pink Peony Set :Pink Peony Illuminating Bronzing Powder +Mini Face Blender Brush . 	 0
 COL ltable.Product_id VAL 377 COL ltable.Description VAL Giorgio Armani lasting silk uv foundation spf 20 COL ltable.Color VAL 4.5 	  COL rtable.ID VAL AM0652 COL rtable.Color VAL nan COL rtable.Description VAL Giorgio Armani 'Lasting Silk' UV Foundation SPF 20 	 0
 COL ltable.Product_id VAL 2709 COL ltable.Description VAL Shiseido the makeup powdery foundation COL ltable.Color VAL I00 Very Light Ivory 	  COL rtable.ID VAL AM6274 COL rtable.Color VAL I00 Very Light Ivory COL rtable.Description VAL Shiseido The Makeup Powdery Foundation (REFILL) Sunscreen SPF 16 Color - I 00 Very Light Ivory Full Size 11 g / .38 oz. 	 1
 COL ltable.Product_id VAL 4979 COL ltable.Description VAL Laura Mercier secret camouflage COL ltable.Color VAL SC-8 	  COL rtable.ID VAL AM5391 COL rtable.Color VAL SC-1 COL rtable.Description VAL Laura Mercier Secret Camouflage SC-1 One Size 	 0
 COL ltable.Product_id VAL 9854 COL ltable.Description VAL Bobbi Brown foundation stick COL ltable.Color VAL Honey 	  COL rtable.ID VAL AM1422 COL rtable.Color VAL Warm Sand COL rtable.Description VAL Bobbi Brown Foundation Stick Warm Sand # 2.5 Full Size (Box) 	 0
