 COL ltable.id VAL 45125 COL ltable.bike_name VAL Yamaha YZF R15 COL ltable.city_posted VAL Delhi COL ltable.color VAL blue 	  COL rtable.id VAL 15372 COL rtable.bike_name VAL Yamaha YZF R15 V1 COL rtable.city_posted VAL Delhi COL rtable.color VAL black 	 0
 COL ltable.id VAL 43710 COL ltable.bike_name VAL Bajaj Pulsar 150cc Dtsi COL ltable.city_posted VAL Delhi COL ltable.color VAL black 	  COL rtable.id VAL 32566 COL rtable.bike_name VAL Bajaj Pulsar 150 DTS- i Standard COL rtable.city_posted VAL Delhi COL rtable.color VAL black 	 1
 COL ltable.id VAL 47093 COL ltable.bike_name VAL Bajaj Avenger 220 COL ltable.city_posted VAL Delhi COL ltable.color VAL blue 	  COL rtable.id VAL 9583 COL rtable.bike_name VAL Bajaj Avenger 220 DTS- i COL rtable.city_posted VAL Delhi COL rtable.color VAL blue 	 1
 COL ltable.id VAL 39631 COL ltable.bike_name VAL Bajaj Pulsar 150cc Dtsi COL ltable.city_posted VAL Mumbai COL ltable.color VAL black 	  COL rtable.id VAL 23067 COL rtable.bike_name VAL Bajaj Pulsar 150 DTS- i Standard COL rtable.city_posted VAL Mumbai COL rtable.color VAL black 	 1
 COL ltable.id VAL 37310 COL ltable.bike_name VAL Hero Motocorp Xtreme Sports Single Disc COL ltable.city_posted VAL Mumbai COL ltable.color VAL black 	  COL rtable.id VAL 34010 COL rtable.bike_name VAL Hero Xtreme Sports Front Disc Self COL rtable.city_posted VAL Mumbai COL rtable.color VAL black 	 1
 COL ltable.id VAL 42699 COL ltable.bike_name VAL Bajaj Pulsar 180cc Dtsi COL ltable.city_posted VAL Delhi COL ltable.color VAL blue 	  COL rtable.id VAL 29494 COL rtable.bike_name VAL Bajaj Pulsar 180 DTS- i Standard COL rtable.city_posted VAL Delhi COL rtable.color VAL black 	 0
 COL ltable.id VAL 42803 COL ltable.bike_name VAL Hero Honda Splendor Plus COL ltable.city_posted VAL Delhi COL ltable.color VAL black 	  COL rtable.id VAL 27834 COL rtable.bike_name VAL Hero Honda Karizma Standard COL rtable.city_posted VAL Delhi COL rtable.color VAL yellow 	 0
 COL ltable.id VAL 36700 COL ltable.bike_name VAL Honda Unicorn Alloy COL ltable.city_posted VAL Mumbai COL ltable.color VAL black 	  COL rtable.id VAL 4875 COL rtable.bike_name VAL Honda CB Unicorn Standard COL rtable.city_posted VAL Mumbai COL rtable.color VAL silver 	 0
 COL ltable.id VAL 44341 COL ltable.bike_name VAL Yamaha FZ16 COL ltable.city_posted VAL Bangalore COL ltable.color VAL black 	  COL rtable.id VAL 18918 COL rtable.bike_name VAL Yamaha SZ X Standard COL rtable.city_posted VAL Bangalore COL rtable.color VAL grey 	 0
 COL ltable.id VAL 46385 COL ltable.bike_name VAL Hero Honda Passion Pro COL ltable.city_posted VAL Mumbai COL ltable.color VAL black 	  COL rtable.id VAL 30702 COL rtable.bike_name VAL Hero Honda Karizma Standard COL rtable.city_posted VAL Mumbai COL rtable.color VAL grey 	 0
 COL ltable.id VAL 43159 COL ltable.bike_name VAL Hero Honda Karizma R COL ltable.city_posted VAL Delhi COL ltable.color VAL black 	  COL rtable.id VAL 8494 COL rtable.bike_name VAL Hero Karizma R COL rtable.city_posted VAL Delhi COL rtable.color VAL red 	 0
 COL ltable.id VAL 46760 COL ltable.bike_name VAL Yamaha FZ S COL ltable.city_posted VAL Bangalore COL ltable.color VAL red 	  COL rtable.id VAL 29928 COL rtable.bike_name VAL Yamaha FZ16 Standard COL rtable.city_posted VAL Bangalore COL rtable.color VAL black 	 0
 COL ltable.id VAL 42533 COL ltable.bike_name VAL Bajaj Pulsar 180cc Dtsi COL ltable.city_posted VAL Delhi COL ltable.color VAL blue 	  COL rtable.id VAL 11002 COL rtable.bike_name VAL Bajaj Pulsar 180 DTS- i Standard COL rtable.city_posted VAL Delhi COL rtable.color VAL colour 	 0
 COL ltable.id VAL 37264 COL ltable.bike_name VAL Hero Honda Karizma R COL ltable.city_posted VAL Bangalore COL ltable.color VAL black 	  COL rtable.id VAL 21993 COL rtable.bike_name VAL Hero Honda Splendor Plus Drum COL rtable.city_posted VAL Bangalore COL rtable.color VAL black 	 0
 COL ltable.id VAL 45574 COL ltable.bike_name VAL Bajaj Avenger 220 COL ltable.city_posted VAL Mumbai COL ltable.color VAL red 	  COL rtable.id VAL 4224 COL rtable.bike_name VAL Bajaj Pulsar 220F Standard COL rtable.city_posted VAL Mumbai COL rtable.color VAL blue 	 0
 COL ltable.id VAL 43491 COL ltable.bike_name VAL Bajaj Pulsar 150cc Dtsi COL ltable.city_posted VAL Delhi COL ltable.color VAL red 	  COL rtable.id VAL 25071 COL rtable.bike_name VAL Bajaj Pulsar 150 DTS- i Standard COL rtable.city_posted VAL Delhi COL rtable.color VAL red 	 1
 COL ltable.id VAL 38613 COL ltable.bike_name VAL Hero Honda Karizma R COL ltable.city_posted VAL Bangalore COL ltable.color VAL yellow 	  COL rtable.id VAL 24858 COL rtable.bike_name VAL Hero Honda Splendor Plus Drum COL rtable.city_posted VAL Bangalore COL rtable.color VAL black 	 0
 COL ltable.id VAL 38419 COL ltable.bike_name VAL Yamaha YZF R15 COL ltable.city_posted VAL Delhi COL ltable.color VAL blue 	  COL rtable.id VAL 11287 COL rtable.bike_name VAL Yamaha FZ S Standard COL rtable.city_posted VAL Delhi COL rtable.color VAL black 	 0
 COL ltable.id VAL 44841 COL ltable.bike_name VAL Bajaj Pulsar 180cc Dtsi COL ltable.city_posted VAL Bangalore COL ltable.color VAL black 	  COL rtable.id VAL 17451 COL rtable.bike_name VAL Bajaj Pulsar 180 DTS- i Standard COL rtable.city_posted VAL Bangalore COL rtable.color VAL black 	 1
 COL ltable.id VAL 39989 COL ltable.bike_name VAL Hero Honda Cbz Xtreme Self Start COL ltable.city_posted VAL Delhi COL ltable.color VAL black 	  COL rtable.id VAL 18362 COL rtable.bike_name VAL Hero Honda Passion PRO Standard COL rtable.city_posted VAL Delhi COL rtable.color VAL black 	 0
 COL ltable.id VAL 44211 COL ltable.bike_name VAL Bajaj Discover 125 Disc COL ltable.city_posted VAL Mumbai COL ltable.color VAL maroon 	  COL rtable.id VAL 5846 COL rtable.bike_name VAL Bajaj Discover125 Drum Brake COL rtable.city_posted VAL Mumbai COL rtable.color VAL black 	 0
 COL ltable.id VAL 41534 COL ltable.bike_name VAL Bajaj Pulsar 180cc Dtsi COL ltable.city_posted VAL Delhi COL ltable.color VAL black 	  COL rtable.id VAL 5186 COL rtable.bike_name VAL Bajaj Pulsar 180 DTS- i Standard COL rtable.city_posted VAL Delhi COL rtable.color VAL black 	 1
 COL ltable.id VAL 38219 COL ltable.bike_name VAL Bajaj CT 100 Spoke COL ltable.city_posted VAL Mumbai COL ltable.color VAL red 	  COL rtable.id VAL 4164 COL rtable.bike_name VAL Bajaj Ct 100 COL rtable.city_posted VAL Mumbai COL rtable.color VAL red 	 1
 COL ltable.id VAL 46490 COL ltable.bike_name VAL Yamaha FZ16 COL ltable.city_posted VAL Delhi COL ltable.color VAL green 	  COL rtable.id VAL 22515 COL rtable.bike_name VAL Yamaha FZ S Standard COL rtable.city_posted VAL Delhi COL rtable.color VAL green 	 0
 COL ltable.id VAL 44658 COL ltable.bike_name VAL Hero Honda Splendor Nxg COL ltable.city_posted VAL Delhi COL ltable.color VAL black 	  COL rtable.id VAL 20005 COL rtable.bike_name VAL Hero Honda CD Dawn Standard COL rtable.city_posted VAL Delhi COL rtable.color VAL black 	 0
 COL ltable.id VAL 36737 COL ltable.bike_name VAL Yamaha FZ16 COL ltable.city_posted VAL Delhi COL ltable.color VAL orange 	  COL rtable.id VAL 30675 COL rtable.bike_name VAL Yamaha Fazer Standard COL rtable.city_posted VAL Delhi COL rtable.color VAL blue 	 0
 COL ltable.id VAL 37935 COL ltable.bike_name VAL Yamaha SZ RR COL ltable.city_posted VAL Delhi COL ltable.color VAL blue 	  COL rtable.id VAL 15189 COL rtable.bike_name VAL Yamaha YZF R15 V 2.0 COL rtable.city_posted VAL Delhi COL rtable.color VAL blue 	 0
 COL ltable.id VAL 37413 COL ltable.bike_name VAL Bajaj Discover 125 M Drum COL ltable.city_posted VAL Delhi COL ltable.color VAL black 	  COL rtable.id VAL 7878 COL rtable.bike_name VAL Bajaj Discover125 Drum Brake COL rtable.city_posted VAL Delhi COL rtable.color VAL black 	 1
 COL ltable.id VAL 45159 COL ltable.bike_name VAL Bajaj Pulsar 150cc Dtsi COL ltable.city_posted VAL Delhi COL ltable.color VAL black 	  COL rtable.id VAL 11864 COL rtable.bike_name VAL Bajaj Pulsar 150 DTS- i Kick Start COL rtable.city_posted VAL Delhi COL rtable.color VAL black 	 1
 COL ltable.id VAL 44080 COL ltable.bike_name VAL Bajaj Pulsar 150cc Dtsi COL ltable.city_posted VAL Delhi COL ltable.color VAL silver 	  COL rtable.id VAL 23579 COL rtable.bike_name VAL Bajaj Pulsar 150 DTS- i Standard COL rtable.city_posted VAL Delhi COL rtable.color VAL black 	 0
 COL ltable.id VAL 42596 COL ltable.bike_name VAL Bajaj Pulsar 150cc Dtsi COL ltable.city_posted VAL Bangalore COL ltable.color VAL red 	  COL rtable.id VAL 32517 COL rtable.bike_name VAL Bajaj Pulsar 150 DTS- i Standard COL rtable.city_posted VAL Bangalore COL rtable.color VAL black 	 0
 COL ltable.id VAL 43793 COL ltable.bike_name VAL Royal Enfield Thunderbird 350 COL ltable.city_posted VAL Bangalore COL ltable.color VAL black 	  COL rtable.id VAL 27009 COL rtable.bike_name VAL Royal Enfield Electra Standard COL rtable.city_posted VAL Bangalore COL rtable.color VAL black 	 0
 COL ltable.id VAL 36472 COL ltable.bike_name VAL Bajaj Pulsar 150cc Dtsi COL ltable.city_posted VAL Mumbai COL ltable.color VAL black 	  COL rtable.id VAL 10055 COL rtable.bike_name VAL Bajaj Pulsar 150 DTS- i Standard COL rtable.city_posted VAL Mumbai COL rtable.color VAL black 	 1
 COL ltable.id VAL 41827 COL ltable.bike_name VAL Royal Enfield Thunderbird 350 COL ltable.city_posted VAL Delhi COL ltable.color VAL Lightning 	  COL rtable.id VAL 22493 COL rtable.bike_name VAL Royal Enfield Thunderbird 350 Disc COL rtable.city_posted VAL Delhi COL rtable.color VAL black 	 0
 COL ltable.id VAL 39088 COL ltable.bike_name VAL Royal Enfield Bullet Electra Twinspark COL ltable.city_posted VAL Delhi COL ltable.color VAL maroon 	  COL rtable.id VAL 9678 COL rtable.bike_name VAL Royal Enfield Bullet Electra Twinspark Disc/Electric start COL rtable.city_posted VAL Delhi COL rtable.color VAL silver 	 0
 COL ltable.id VAL 37819 COL ltable.bike_name VAL Bajaj Pulsar 200 NS COL ltable.city_posted VAL Mumbai COL ltable.color VAL yellow 	  COL rtable.id VAL 28182 COL rtable.bike_name VAL Bajaj Pulsar NS200 Standard COL rtable.city_posted VAL Mumbai COL rtable.color VAL yellow 	 1
 COL ltable.id VAL 37787 COL ltable.bike_name VAL Yamaha FZ S COL ltable.city_posted VAL Bangalore COL ltable.color VAL black 	  COL rtable.id VAL 33896 COL rtable.bike_name VAL Yamaha FZ S Standard COL rtable.city_posted VAL Bangalore COL rtable.color VAL black 	 1
 COL ltable.id VAL 37909 COL ltable.bike_name VAL Bajaj Avenger 220 COL ltable.city_posted VAL Bangalore COL ltable.color VAL black 	  COL rtable.id VAL 23670 COL rtable.bike_name VAL Bajaj Pulsar 220F Standard COL rtable.city_posted VAL Bangalore COL rtable.color VAL black 	 0
 COL ltable.id VAL 45881 COL ltable.bike_name VAL Royal Enfield Thunderbird 350 COL ltable.city_posted VAL Delhi COL ltable.color VAL Twilight 	  COL rtable.id VAL 30386 COL rtable.bike_name VAL Royal Enfield Thunderbird 350 Disc COL rtable.city_posted VAL Delhi COL rtable.color VAL black 	 0
 COL ltable.id VAL 38376 COL ltable.bike_name VAL Bajaj Pulsar 220F Dtsi COL ltable.city_posted VAL Delhi COL ltable.color VAL black 	  COL rtable.id VAL 2842 COL rtable.bike_name VAL Bajaj Avenger 220 DTS- i COL rtable.city_posted VAL Delhi COL rtable.color VAL red 	 0
 COL ltable.id VAL 40886 COL ltable.bike_name VAL Yamaha FZ FI Version 2.0 COL ltable.city_posted VAL Bangalore COL ltable.color VAL red 	  COL rtable.id VAL 32067 COL rtable.bike_name VAL Yamaha FZ S Standard COL rtable.city_posted VAL Bangalore COL rtable.color VAL black 	 0
 COL ltable.id VAL 47674 COL ltable.bike_name VAL Hero Honda Karizma Zmr Pgm Fi COL ltable.city_posted VAL Delhi COL ltable.color VAL white 	  COL rtable.id VAL 25523 COL rtable.bike_name VAL Hero Honda Hunk Standard COL rtable.city_posted VAL Delhi COL rtable.color VAL silver 	 0
 COL ltable.id VAL 44204 COL ltable.bike_name VAL Yamaha FZ FI Version 2.0 COL ltable.city_posted VAL Mumbai COL ltable.color VAL red 	  COL rtable.id VAL 15901 COL rtable.bike_name VAL Yamaha FZ S Standard COL rtable.city_posted VAL Mumbai COL rtable.color VAL black 	 0
 COL ltable.id VAL 39240 COL ltable.bike_name VAL Honda Stunner CBF Self Disc Alloy COL ltable.city_posted VAL Mumbai COL ltable.color VAL maroon 	  COL rtable.id VAL 12741 COL rtable.bike_name VAL Honda CBF Stunner FI COL rtable.city_posted VAL Mumbai COL rtable.color VAL maroon 	 1
 COL ltable.id VAL 41366 COL ltable.bike_name VAL Bajaj Avenger 220 COL ltable.city_posted VAL Bangalore COL ltable.color VAL black 	  COL rtable.id VAL 26675 COL rtable.bike_name VAL Bajaj Avenger 220 DTS- i COL rtable.city_posted VAL Bangalore COL rtable.color VAL black 	 1
 COL ltable.id VAL 36245 COL ltable.bike_name VAL Yamaha YZF R15 Version 2.0 COL ltable.city_posted VAL Delhi COL ltable.color VAL red 	  COL rtable.id VAL 29302 COL rtable.bike_name VAL Yamaha YZF R15 V 2.0 COL rtable.city_posted VAL Delhi COL rtable.color VAL red 	 1
 COL ltable.id VAL 39464 COL ltable.bike_name VAL Bajaj Pulsar 200 NS COL ltable.city_posted VAL Mumbai COL ltable.color VAL blue 	  COL rtable.id VAL 9286 COL rtable.bike_name VAL Bajaj Pulsar 200 Standard COL rtable.city_posted VAL Mumbai COL rtable.color VAL blue 	 1
 COL ltable.id VAL 44233 COL ltable.bike_name VAL Honda CB Twister Self Drum Alloy COL ltable.city_posted VAL Bangalore COL ltable.color VAL green 	  COL rtable.id VAL 34521 COL rtable.bike_name VAL Honda CB Twister Disc/Electric start COL rtable.city_posted VAL Bangalore COL rtable.color VAL red 	 0
 COL ltable.id VAL 41936 COL ltable.bike_name VAL Honda Stunner CBF Self Disc Alloy COL ltable.city_posted VAL Delhi COL ltable.color VAL yellow 	  COL rtable.id VAL 18937 COL rtable.bike_name VAL Hero Honda Glamour Disc Self COL rtable.city_posted VAL Delhi COL rtable.color VAL red 	 0
 COL ltable.id VAL 37140 COL ltable.bike_name VAL Honda Dream Neo Self Drum Alloy COL ltable.city_posted VAL Mumbai COL ltable.color VAL black 	  COL rtable.id VAL 22853 COL rtable.bike_name VAL Honda Dream Yuga Electric Start/Alloy COL rtable.city_posted VAL Mumbai COL rtable.color VAL blue 	 0
 COL ltable.id VAL 42793 COL ltable.bike_name VAL Yamaha FZ16 COL ltable.city_posted VAL Bangalore COL ltable.color VAL black 	  COL rtable.id VAL 25085 COL rtable.bike_name VAL Yamaha FZ16 Standard COL rtable.city_posted VAL Bangalore COL rtable.color VAL red 	 0
 COL ltable.id VAL 48100 COL ltable.bike_name VAL Bajaj Pulsar 150cc Dtsi COL ltable.city_posted VAL Delhi COL ltable.color VAL black 	  COL rtable.id VAL 11864 COL rtable.bike_name VAL Bajaj Pulsar 150 DTS- i Kick Start COL rtable.city_posted VAL Delhi COL rtable.color VAL black 	 1
 COL ltable.id VAL 45232 COL ltable.bike_name VAL Royal Enfield Bullet Electra Twinspark COL ltable.city_posted VAL Delhi COL ltable.color VAL silver 	  COL rtable.id VAL 13324 COL rtable.bike_name VAL Royal Enfield Electra 5 S Drum Kick COL rtable.city_posted VAL Delhi COL rtable.color VAL black 	 0
 COL ltable.id VAL 41836 COL ltable.bike_name VAL TVS Star City Alloy COL ltable.city_posted VAL Delhi COL ltable.color VAL black 	  COL rtable.id VAL 22931 COL rtable.bike_name VAL TVS Star City Alloy wheels COL rtable.city_posted VAL Delhi COL rtable.color VAL grey 	 0
 COL ltable.id VAL 45728 COL ltable.bike_name VAL Bajaj Avenger 220 COL ltable.city_posted VAL Mumbai COL ltable.color VAL red 	  COL rtable.id VAL 14433 COL rtable.bike_name VAL Bajaj Avenger 220 DTS- i COL rtable.city_posted VAL Mumbai COL rtable.color VAL black 	 0
 COL ltable.id VAL 36334 COL ltable.bike_name VAL Hero Honda Karizma Zmr Pgm Fi COL ltable.city_posted VAL Mumbai COL ltable.color VAL red 	  COL rtable.id VAL 34340 COL rtable.bike_name VAL Hero Karizma ZMR 2014 Standard COL rtable.city_posted VAL Mumbai COL rtable.color VAL red 	 1
 COL ltable.id VAL 39654 COL ltable.bike_name VAL Yamaha FZS FI Version 2.0 COL ltable.city_posted VAL Delhi COL ltable.color VAL green 	  COL rtable.id VAL 32820 COL rtable.bike_name VAL Yamaha YZF R15 V 2.0 COL rtable.city_posted VAL Delhi COL rtable.color VAL black 	 0
 COL ltable.id VAL 38649 COL ltable.bike_name VAL Bajaj Pulsar 180cc Dtsi COL ltable.city_posted VAL Delhi COL ltable.color VAL black 	  COL rtable.id VAL 6211 COL rtable.bike_name VAL Bajaj Pulsar 180 DTS- i Standard COL rtable.city_posted VAL Delhi COL rtable.color VAL silver 	 0
 COL ltable.id VAL 37465 COL ltable.bike_name VAL Bajaj Pulsar 220F Dtsi COL ltable.city_posted VAL Delhi COL ltable.color VAL black 	  COL rtable.id VAL 30892 COL rtable.bike_name VAL Bajaj Avenger 220 DTS- i COL rtable.city_posted VAL Delhi COL rtable.color VAL blue 	 0
 COL ltable.id VAL 41335 COL ltable.bike_name VAL Bajaj Avenger 220 COL ltable.city_posted VAL Mumbai COL ltable.color VAL red 	  COL rtable.id VAL 7753 COL rtable.bike_name VAL Bajaj Avenger 220 DTS- i COL rtable.city_posted VAL Mumbai COL rtable.color VAL blue 	 0
 COL ltable.id VAL 36659 COL ltable.bike_name VAL Yamaha SZ RR COL ltable.city_posted VAL Bangalore COL ltable.color VAL black 	  COL rtable.id VAL 14061 COL rtable.bike_name VAL Yamaha SZ R Standard COL rtable.city_posted VAL Bangalore COL rtable.color VAL white 	 0
 COL ltable.id VAL 47127 COL ltable.bike_name VAL Bajaj Discover 150 S Disc COL ltable.city_posted VAL Delhi COL ltable.color VAL black 	  COL rtable.id VAL 578 COL rtable.bike_name VAL Bajaj Pulsar 150 DTS- i COL rtable.city_posted VAL Delhi COL rtable.color VAL black 	 0
 COL ltable.id VAL 43784 COL ltable.bike_name VAL Hero Honda Karizma Zmr Pgm Fi COL ltable.city_posted VAL Bangalore COL ltable.color VAL white 	  COL rtable.id VAL 26858 COL rtable.bike_name VAL Hero Honda Splendor Plus Disc COL rtable.city_posted VAL Bangalore COL rtable.color VAL blue 	 0
 COL ltable.id VAL 37412 COL ltable.bike_name VAL Bajaj Pulsar 180cc Dtsi COL ltable.city_posted VAL Delhi COL ltable.color VAL red 	  COL rtable.id VAL 5703 COL rtable.bike_name VAL Bajaj Pulsar 180 DTS- i Standard COL rtable.city_posted VAL Delhi COL rtable.color VAL black 	 0
 COL ltable.id VAL 39429 COL ltable.bike_name VAL Bajaj Pulsar 220F Dtsi COL ltable.city_posted VAL Bangalore COL ltable.color VAL black 	  COL rtable.id VAL 30027 COL rtable.bike_name VAL Bajaj Pulsar 220F Standard COL rtable.city_posted VAL Bangalore COL rtable.color VAL black 	 1
 COL ltable.id VAL 37252 COL ltable.bike_name VAL Royal Enfield Continental Gt 535 COL ltable.city_posted VAL Mumbai COL ltable.color VAL yellow 	  COL rtable.id VAL 19920 COL rtable.bike_name VAL Royal Enfield Continental GT (Cafe Racer) Standard COL rtable.city_posted VAL Mumbai COL rtable.color VAL red 	 0
 COL ltable.id VAL 39856 COL ltable.bike_name VAL Honda CB Trigger STD COL ltable.city_posted VAL Mumbai COL ltable.color VAL black 	  COL rtable.id VAL 33663 COL rtable.bike_name VAL Honda CB Unicorn Standard COL rtable.city_posted VAL Mumbai COL rtable.color VAL red 	 0
 COL ltable.id VAL 45319 COL ltable.bike_name VAL Hero Honda Passion Plus COL ltable.city_posted VAL Mumbai COL ltable.color VAL blue 	  COL rtable.id VAL 32802 COL rtable.bike_name VAL Hero Passion PRO Kick Spoke COL rtable.city_posted VAL Mumbai COL rtable.color VAL black 	 0
 COL ltable.id VAL 44801 COL ltable.bike_name VAL Hero Honda Cbz Xtreme Self Start COL ltable.city_posted VAL Delhi COL ltable.color VAL black 	  COL rtable.id VAL 21783 COL rtable.bike_name VAL Hero Honda Karizma ZMR Standard COL rtable.city_posted VAL Delhi COL rtable.color VAL red 	 0
 COL ltable.id VAL 42768 COL ltable.bike_name VAL Bajaj Pulsar 150cc Dtsi COL ltable.city_posted VAL Bangalore COL ltable.color VAL black 	  COL rtable.id VAL 30752 COL rtable.bike_name VAL Bajaj Pulsar 150 DTS- i Standard COL rtable.city_posted VAL Bangalore COL rtable.color VAL black 	 1
 COL ltable.id VAL 43713 COL ltable.bike_name VAL Bajaj Pulsar 150cc Dtsi COL ltable.city_posted VAL Delhi COL ltable.color VAL black 	  COL rtable.id VAL 11187 COL rtable.bike_name VAL Bajaj Pulsar 150 DTS- i Kick Start COL rtable.city_posted VAL Delhi COL rtable.color VAL black 	 1
 COL ltable.id VAL 39906 COL ltable.bike_name VAL Yamaha YZF R15 Version 2.0 COL ltable.city_posted VAL Delhi COL ltable.color VAL black 	  COL rtable.id VAL 34438 COL rtable.bike_name VAL Yamaha YZF R15 V 2.0 COL rtable.city_posted VAL Delhi COL rtable.color VAL blue 	 0
 COL ltable.id VAL 43514 COL ltable.bike_name VAL Bajaj Pulsar 220F Dtsi COL ltable.city_posted VAL Delhi COL ltable.color VAL blue 	  COL rtable.id VAL 35627 COL rtable.bike_name VAL Bajaj Avenger 220 DTS- i COL rtable.city_posted VAL Delhi COL rtable.color VAL black 	 0
 COL ltable.id VAL 43159 COL ltable.bike_name VAL Hero Honda Karizma R COL ltable.city_posted VAL Delhi COL ltable.color VAL black 	  COL rtable.id VAL 15169 COL rtable.bike_name VAL Hero Honda CBZ extreme Self COL rtable.city_posted VAL Delhi COL rtable.color VAL black 	 0
 COL ltable.id VAL 46068 COL ltable.bike_name VAL Yamaha FZ S COL ltable.city_posted VAL Bangalore COL ltable.color VAL black 	  COL rtable.id VAL 25221 COL rtable.bike_name VAL Yamaha Fazer Standard COL rtable.city_posted VAL Bangalore COL rtable.color VAL black 	 0
 COL ltable.id VAL 36717 COL ltable.bike_name VAL Hero Honda Hunk COL ltable.city_posted VAL Delhi COL ltable.color VAL red 	  COL rtable.id VAL 33756 COL rtable.bike_name VAL Hero Honda Passion Plus Drum COL rtable.city_posted VAL Delhi COL rtable.color VAL blue 	 0
 COL ltable.id VAL 36521 COL ltable.bike_name VAL Bajaj Pulsar 150cc Dtsi COL ltable.city_posted VAL Bangalore COL ltable.color VAL blue 	  COL rtable.id VAL 13718 COL rtable.bike_name VAL Bajaj Pulsar 150 DTS- i Kick Start COL rtable.city_posted VAL Bangalore COL rtable.color VAL black 	 0
 COL ltable.id VAL 45266 COL ltable.bike_name VAL Bajaj Avenger 220 COL ltable.city_posted VAL Bangalore COL ltable.color VAL blue 	  COL rtable.id VAL 35846 COL rtable.bike_name VAL Bajaj Avenger 220 DTS- i COL rtable.city_posted VAL Bangalore COL rtable.color VAL black 	 0
 COL ltable.id VAL 39929 COL ltable.bike_name VAL Bajaj Pulsar 135 COL ltable.city_posted VAL Delhi COL ltable.color VAL red 	  COL rtable.id VAL 26674 COL rtable.bike_name VAL Bajaj Pulsar 135 LS Standard COL rtable.city_posted VAL Delhi COL rtable.color VAL red 	 1
 COL ltable.id VAL 46382 COL ltable.bike_name VAL Hero Honda Cd Deluxe COL ltable.city_posted VAL Mumbai COL ltable.color VAL black 	  COL rtable.id VAL 33259 COL rtable.bike_name VAL Honda Activa Deluxe COL rtable.city_posted VAL Mumbai COL rtable.color VAL black 	 0
 COL ltable.id VAL 36930 COL ltable.bike_name VAL Hero Honda Splendor Plus COL ltable.city_posted VAL Delhi COL ltable.color VAL black 	  COL rtable.id VAL 22799 COL rtable.bike_name VAL Hero Honda Splendor PRO Self COL rtable.city_posted VAL Delhi COL rtable.color VAL black 	 0
 COL ltable.id VAL 44579 COL ltable.bike_name VAL Yamaha FZ S COL ltable.city_posted VAL Delhi COL ltable.color VAL blue 	  COL rtable.id VAL 13185 COL rtable.bike_name VAL Yamaha YZF R15 V 2.0 COL rtable.city_posted VAL Delhi COL rtable.color VAL black 	 0
 COL ltable.id VAL 38364 COL ltable.bike_name VAL Bajaj Xcd Exceed 125cc Dtssi COL ltable.city_posted VAL Delhi COL ltable.color VAL red 	  COL rtable.id VAL 18695 COL rtable.bike_name VAL Bajaj Xcd 125 cc COL rtable.city_posted VAL Delhi COL rtable.color VAL silver 	 0
 COL ltable.id VAL 46068 COL ltable.bike_name VAL Yamaha FZ S COL ltable.city_posted VAL Bangalore COL ltable.color VAL black 	  COL rtable.id VAL 25063 COL rtable.bike_name VAL Yamaha FZ16 Standard COL rtable.city_posted VAL Bangalore COL rtable.color VAL black 	 0
 COL ltable.id VAL 40643 COL ltable.bike_name VAL Yamaha FZS FI Version 2.0 COL ltable.city_posted VAL Bangalore COL ltable.color VAL blue 	  COL rtable.id VAL 26909 COL rtable.bike_name VAL Yamaha YZF R15 V 2.0 COL rtable.city_posted VAL Bangalore COL rtable.color VAL limited edition 	 0
 COL ltable.id VAL 36335 COL ltable.bike_name VAL Hero Honda Passion Plus COL ltable.city_posted VAL Mumbai COL ltable.color VAL black 	  COL rtable.id VAL 27261 COL rtable.bike_name VAL Hero Honda Passion PRO Standard COL rtable.city_posted VAL Mumbai COL rtable.color VAL black 	 1
 COL ltable.id VAL 43518 COL ltable.bike_name VAL Royal Enfield Thunderbird 350 COL ltable.city_posted VAL Mumbai COL ltable.color VAL black 	  COL rtable.id VAL 32899 COL rtable.bike_name VAL Royal Enfield Thunderbird 350 Disc Self COL rtable.city_posted VAL Mumbai COL rtable.color VAL blue 	 0
 COL ltable.id VAL 43165 COL ltable.bike_name VAL Yamaha FZ16 COL ltable.city_posted VAL Bangalore COL ltable.color VAL black 	  COL rtable.id VAL 24338 COL rtable.bike_name VAL Yamaha FZ S Standard COL rtable.city_posted VAL Bangalore COL rtable.color VAL green 	 0
 COL ltable.id VAL 37839 COL ltable.bike_name VAL Bajaj Pulsar 180cc Dtsi COL ltable.city_posted VAL Bangalore COL ltable.color VAL red 	  COL rtable.id VAL 2627 COL rtable.bike_name VAL Bajaj Pulsar 180 DTS- i Standard COL rtable.city_posted VAL Bangalore COL rtable.color VAL red 	 1
 COL ltable.id VAL 37731 COL ltable.bike_name VAL Bajaj Pulsar 150cc Dtsi COL ltable.city_posted VAL Mumbai COL ltable.color VAL black 	  COL rtable.id VAL 10055 COL rtable.bike_name VAL Bajaj Pulsar 150 DTS- i Standard COL rtable.city_posted VAL Mumbai COL rtable.color VAL black 	 1
